// lang CZE
// ver 0.1
// for game ver 1.0a
// author rcx
// Codes can't start with : §, -, 0-9

//===System Errors
AssertCheck	---

//===Init
LoadingGame	Nahrávám hru
LoadingFailed	Nahrátí hry se nepodařilo

ContactMG	www.managames.com/mail_en

InvalidKey	Váš registrační klíč je chybný!\nProsím, ozvěte se našemu týmu [>ContactMG],\npošlete jméno, příjmení a zákaznické číslo.\n
InvalidKeyTitle	Chybný klíč

TrialInfo	Hru si užíváte v testovacím režimu.\n\nPokud jste si hru koupili, v což doufáme, prosím zadejte své zákaznické číslo.
Register	Registrace plné verze hry
EnterCustomerID	Zajedte zákaznické číslo
Registered	{0}, podařilos e Vám úspěšně zaregistrovat tuto hru.\n\nPřejeme hodně dobrodružství a zábavy !
CantWWW		Nemohu se připojit na server managames.com .\n\nProsím zkontrolujte své připojení k internetu a zkuste to znova.
ContactingWWW	Připojuji se na server managames.com . Prosím vydržte.
WrongID		Zadáno chybné zákaznické číslo.\n\nZkuste to prosím znovu. Pokud si myslíte, že je chyba na našem konci,\nozvěte se našemu týmu [>ContactMG] a pošlete jim své zákaznické číslo.
FailedKey	Klíč se podařilo stáhnout, ale vypadá to, že nefunguje !\n\nProsím, ozvěte se našemu týmu [>ContactMG],\npošlete jméno, příjmení a zákaznické číslo.
RegisterInfo	Registrační informace
Info		Informace
RegInfo		Hra registrována na:\n\n{0}\n{1}\n

//=== Global
On		Zapnuto
Off		Vypnuto
Default		Původní
Back		Zpět
Ok		Potvrdit
Auto		Automaticky
None		Žádný
Done		Hotovo
Cancel		Zrušit
Remove		Odstranit
Warning		Upozornění
Confirm		Potvrdit
Submit		Odeslat

//=== Main Menu
StartLevel	Začít patro
StartGame	Začít novou hru
ResumeGame	Pokračovat ve hře
Options		Nastavení
MapEditor	Editor map
Exit		Konec
Credits		Závěrečné titulky
ShowDataFolder	Ukázat složku s daty
Build		Verze

//=== Options Menu
FullScreen	Přes celou obrazovku
Windowed	V okně
VideoOptions	Grafika
Controls	Ovládání
GameOptions	Nastavení hry
Interface	Rozhraní
Audio		Zvuk

//=== Game Options Menu
Difficulty	Obtížnost
DiffAdvanced	Rozšířené nastavení 
EnemyHP		HP nepřátel
EnemyDps	DPS nepřátel
GuiArrows	Zobrazit šipky
TooltipOnCursor	Nápověda vedle ukazatele
GuiDpsLog	Zobrazit historii DPS
DevMode		Vývojářský režim
GhostMode	Jako duch
ShowFps		Zobrazit FPS
Analytics	Analytická data
TipAnalytics	Umožní hře odesílat anonymní analytická data.\nTak se vývojáři v Mana Games dozví, jestli má některý boss příliš tuhý kořínek nebo naopak, jste si ho téměř nevšimli a podobné informace.
AutoSave	Automaticky ukládat po skončení souboje

AutoMapping	Automatické mapování
ConfirmAutoMap	Zapnutí mapování znamená, že nebudete vázání na hledání magického svitku s mapou pro každé patro.\n\nAle také to dramaticky sníží obtížnost hry a atmosféra zoufalosti a ztracenostiv podzemí bude ta tam.\n\nOpravdu nedoporčujeme mapu zapínat, ledaže chcete hru jen proběhnout a rozlehlá, magicky podmanivá patra Vás nezajímají.

GuiScaleTop	Měřítko horního GUI
GuiScaleCenter	Měřítko středního GUI
GuiScaleBottom	Měřítko dolního GUI

Difficulty00	Kojenec	// 0.0 - Kid
Difficulty01	Zvědavec	// 0.2 - Very Easy
Difficulty02	Dobrodruh	// 0.5 - Easy
Difficulty03	Bojovník		// 0.9 - Normal
Difficulty04	Řezník	// 1.0 - Hard
Difficulty05	Stratég	// 1.5 - Very Hard
Difficulty06	Likvidátor	// 2.0 - Impossible

Difficulty07	Aktuální nastavení
Difficulty08	Vlastní

DifficultyInfo	Obtížnost můžete změnit kdykoli během hry.\nStačí jen jít do [>GameOptions].

DescDiff00	Nedá se ani mluvit o obtížnosti. Jediné, co budeš potřebovat, je naučit se léčit svou partičku, ale to jen opravdu ve chvílích nejhorších. Pravá volba pro procházku parkem.
DescDiff01	Ikdyž jsou pro Tebe hry španělskou vesnicí, tak s jedním okem zavřeným by ses na konec hry měl dostat. Pokud nebudeš hru zastavovat pomocí klávesy [>KeyActivePause], tak hra může být i výzvou.
DescDiff02	Už jsi nějakou tu hru hrál a přežití pro Tebe není až takový problém, ale i tak Ti necháme prostor pro drobná zaškobrnutí. Pokud nebudeš hru zastavovat pomocí klávesy [>KeyActivePause], tak hra bude velkou výzvou.
DescDiff03	Pravá volba pro strategické hráče, byť nováčky v této hře - užijete si ji. Hra bez zastavování pomocí klávesy [>KeyActivePause] je téměř nemožná.
DescDiff04	Budeš se muset naučit hrát pomalu poslepu, ale i tak ti jedno či dvě zaškobrtnutí povolíme. Hra bez zastavování pomocí klávesy [>KeyActivePause] je vcelku nemožná.
DescDiff05	Nejen, že se budeš muset naušit hrát téměř jako bůh, ale budeš muset odhalit všechna tajemství a skrýše, abys měl alespoň nějaké vybavení a pár lektvarů. O hraní bez zastavovaní pomocí klávesy [>KeyActivePause] ani neuvažuj.
DescDiff06	Bez hromady štěstí a pár zázraků se dalšího patra nedožiješ, ale od toho jsou výzvy, ne ?
DescDiff07	Ponechat obtížnost, tak jak je nastavena v [>GameOptions].
DescDiff08	Pohraj si s obtížností pomocí šoupátek.

SelectDifficulty	Zvol obtížnost

CheckNewVersion	Ověřovat dostupnost nové verze automaticky
CheckVersionNow	Ověřit dostupnost nové verze právě teď
NoNewVersion	Již si užíváte nejnovější verzi hry.
NewVersion	Nová verze
NewVersionOnWeb	Na serveru je k dispozici nová verze hry.
DownloadNow	Stáhnout ihned !
Changelog	Seznam změn

ChooseLanguage	Choose Language (Změna jazyka)

GameHelpers	Pomocníčci
ItemHighlight	Zvýrazňovat věci
AutoAttackMob	Zaútočit na dalšího nepřítele po smrti aktuálního

AutoPause00	Zastav při prázdné frontě
AutoPause01	Zastav při smrti nepřítele
AutoPause02	Zastav, pokud je někdo KO
AutoPause03	Zastav, pokud je léčitel bez many
AutoPause04	Zastav, pokud je útočník bez many
AutoPause05	Zastav po dlouhém dobití
AutoPause06	Zastav na začátku bitvy
AutoPause07	Zastav, pokud nepřítel útočí na jinou postavu než tanka

GlobalIcons	Globální ikony
DigitalCD	Digital Cooldowns

//=== InGame Menu
InGame		Ve-hře
MainMenu	Hlavní menu
BackToEditor	Zpět do Editoru
SaveGame	Uložit hru
LoadGame	Nahrát hru
NewSave		Uložit na novou pozici
QuickSave	Uložit rychle
Overwriting	Přepisuji '<i>{0}</i>' - <b><color=red>Potvrď dalším klikem</color></b>
DefaultSaveName	MojeHra
ImportParty	Importovat bandu
PartyImported	Banda importována
GameSaved	Hra uložena do '{0}'
GameLoaded	Hra nahrána z '{0}'
SelectDungeon	Vybrat patro
SelectMods	Vybrat rozšíření		//##
Dungeon&Mods	Podzemí & Rozšíření		//##
NoSavedGame	Nemáš žádnou uloženou hru
GameOver	Konec hry
LoadLastGame	Nahrát poslední uloženou hru

CheckAccount	Kontrola licenčního klíče online
SaveLocked	Tvoje uložené hry byly uzamčeny. Prosím nech si zkontrolovat online liceční klíč.\nPokud sis hru nekoupil, tak teď je ten pravý čas.
Unlocked	Tvoje přístupové údaje jsou v pořádku - uložené hry odemčeny !

//=== Select Mods		//##
ModOnRestart	Změny v rozšířeních se projeví až po restartu hry.
ModSelect	Nahrát rozšíření
ModSelect00	Všechna
ModSelect01	Žádná
ModSelect02	Vybraná

//=== Video Options Menu
Gamma		Gamma
TipGamma	Vlevo dole je prsten, měl bys ho vidět v přítmí a měl bys také poznat, že je celý zlatý.
Ambient		Okolí
Brightness	Jas
Contrast	Kontrast
VSync		VSync
ViewRange	Viditelnost
Bloom		Záře
SSAO		SSAO
TipSSAO	Technika pokročilého stínování (SSAO).
Fsaa		Plnohodnotný Anti-Aliasing
TipFsaa		Plnohodnotný Anti-Aliasing metodou FXAA3.
VideoQuality	Kvalita
Deferred	Jednoduché osvělení
TipDeferred	Vypne stíny, vhodné pro opravdu staré grafické karty.
MotionBlur	Pohybová neostrost
FramePerSecond	Snímků za sekundu (FPS)
Fov		Úhel pohledu

QuFastest	Nejrychlejší
QuFast		Rychlá
QuSimple	Běžná
QuGood		Dobrá
QuBeautiful	Krásná
QuFantastic	Fantastická

//=== Controls Menu
MouseSensivity	Citlivost myši
WheelSensivity	Citlivost kolečka myši
InvertMouseY	Otoč osu Y myši
CmdBuffering	Vstupní zásobník
CmdBuffering00	Vypnut
CmdBuffering01	Malý
CmdBuffering02	Velký
ViewBobbing	Pohyb (houpání) kamery
SmoothMouse	Plynulost myši
AutoCenterMouse	Srovnat kameru při pohybu

BindKeys	Klávesy
BindFunction	Funkce
BindKey		Klávesa
BindAltKey	Náhradní klávesa
KeyNone		<Nepřiřazena>

KeyBase		Obecné
KeyAbilities	Dovednosti
KeyEditor	Editor
KeyModSymbol	M
ConfirmDefKEys	Opravdu chcete veškeré klávesy nastavit na původní ?
TipKeyBind	Levým tlačitkem myši nastavíte novou klávesu. Pravým tlačítkem zrušíte aktuálně zvolenou klávesu.
TipKeyBinding	Stiskněte požadovanou klávesu. Pravým tlačítkem myši zrušíte nastavování.

//=== Keys
KeyModifier1	Rozšiřující klávesa 1	  	// Shift
KeyModifier2	Rozšiřující klávesa 2	  	// Control
KeyModifier3	Rozšiřující klávesa 3	  	// Alt

KeyHealthPotion	Lektvar zdraví
KeyManaPotion	Lektvar many

KeyInventory	[>GiInventory]
KeyTalentTree	[>GiTalentTree]
KeyChatLog	[>GiChatLog]
KeyMap		Mapa

KeyEscape	Esc
KeyCycleTarget	Další nepřítel
KeyToon1	Člen bandy 1
KeyToon2	Člen bandy 2
KeyToon3	Člen bandy 3
KeyToon4	Člen bandy 4

KeyQuickSave	[>QuickSave]
KeyQuickLoad	Nahrát rychle
KeyScreenshot	Otisk obrazovky
KeyHideGui	Skrýt GUI

      //=== From Input
KeyMoveForward	Krok vpřed
KeyMoveBackward	Krok vzad
KeyMoveLeft	Krok vlevo
KeyMoveRight	Krok vpravo
KeyTurnLeft	Otočka vlevo
KeyTurnRight	Otočka vpravo
KeyActivePause	Bojová pauza

KeyNextDialog	Další dialog
KeyDpsGraph	[>GuiDpsLog]
KeySelectToons	Označit/Odznačit vybrané členy bandy
KeyAttack	[>GiAttack]
KeyLoot		Sebrat vše ze země	//##

      //=== Ability
KeyRightClick	Odebrat Dovednost z fronty
DescKeyRightClick	Drž stisknutou tuto klávesu spolu s klávesou Dovednosti, kterou chceš odebrat z fronty
DescKeyModifier1	Jedna z rozšiřujících kláves SHIFT, CTRL, ALT, které znásobují množsví přiřaditelných klávesových zkratek
DescKeyModifier2	[>DescKeyModifier1]
DescKeyModifier3	[>DescKeyModifier1]

KeyToonAbility	Člen #{0} Dovednost #{1}

      //=== Editor
KeyEd_SaveMap	Uložit mapu
KeyEd_SaveDungeon	Uložit podzemí
KeyEd_TestDungeon	Test patra
KeyEd_StopTest		[>BackToEditor]

KeyEd_NextLevel	Další patro
KeyEd_PreviousLevel	Předchozí patro
KeyEd_OtherNextLevel	See Other Next Level
KeyEd_OtherPrevLevel	See Other Previous Level
KeyEd_ScrollUp	Posun nahoru
KeyEd_ScrollDown	Posun dolů
KeyEd_ScrollLeft	Posun vlevo
KeyEd_ScrollRight	Posun vpravo

KeyEd_Floor	Podlaha
KeyEd_Ceiling	Strop
KeyEd_Wall	Zeď
KeyEd_Corner	Roh
KeyEd_Prop	Vlastnosti
KeyEd_Field	XXField
KeyEd_Mob	Příšera
KeyEd_Item	Věc
KeyEd_EditCells	XXEdit Cells
KeyEd_Level	[>DungeonLevel]
KeyEd_Dungeon	Podzemí

KeyEd_VerticalUp	Letět nahoru
KeyEd_VerticalDown	Letět dolů
KeyEd_DragOrbit	Posun a kroužení

//=== Audio
MasterVol	Hlasitost
MusicVol	Hlasitost hudby
AmbienceVol	Hlasitost doprovodu

SpeakerMode	Reproduktory
SpeakerMode00	Mono
SpeakerMode01	Stereo
SpeakerMode02	Quad
SpeakerMode03	Surround
SpeakerMode04	5.1
SpeakerMode05	7.1

//=== Party Creation
PartyCreation	Výběr bandy
DefaultParty	Původní banda
CustomParty	Vlastní banda
SelectParty	Upravit bandu
PartySelected	Začít hru
SelectMember	Vyber strážce
MemberDesc	{0}\n{1}\n({2}, {3}, {4}, {5})
ChangeMember	Vyměň strážce
ChangeSoul	Přesuň duši
ShowBaseMember	Moji strážci
ShowUserMember	Původní strážci
ShowMatchMember	Všichni strážci
ShowAllMember	Vhodní strážci
CharDesc	{0} : {1}, {2}, {3}, {4}, {5}
CharDetail	({0}, {1}, {2}, {3}, {4})
NoMatchMember	Nemáš žádného vhodného strážce
NoMember	Nemáš žádného strážce - tak si nějakého stvoř!
SelectForRole	Pro roli: {0}
CreateMember	Vytvoř strážce
DefaultName	[:Pan|Dáma]
DeleteChar	Smaž strážce
ConfirmDelChar	Opravdu se chceš zbavit '{0}' ?\n\nNení už pak cesty zpět !
MainCharacter	<b>Hlavní postava</b>\nJsi duší tohoto strážce.\nHlavní postavu změníš kliknutím na portrét jiného strážce.

CcPass00	Zvol rasu
CcPass01	Zvol pohlaví
CcPass02	Zvol jméno
CcPass03	Zvol třídu
CcPass04	Zvol specializaci
CcPass05	Zvol potrét
CcPass06	Zvol hlas

OverwriteChar	Strážce '{0}' byl již jednou stvořen.\n\nPřejete si [:ho|ji] přepsat ?
Overwrite	Přepsat
IncompatibleMember	Tento stážce se na vybranou roli v bandě nehodí.
IncompatibleParty	Pokud si pro jednotlivé role nevybereš vhodné strážce, bude hra nevyrovnaná, případně i nedohratelná.
IncompatibleClass	Tato třída nemá žádnou vhodnou specializaci pro vybranou roli.
IncompatibleSpec	Tato specializace se pro vybranou roli nehodí.

VoiceAuto	Automaticky
TipVoiceAuto	Nech hlasy na hře, ať nemáš postavy se stejným hlasem.\n\nVšichni Původní strážci mají nastaveno automatické přiřazení hlasu.
Voice		Hlas #{0}

//=== Map Editor
BrushNormal	Brush Normal
BrushSmart	Brush Smart
BrushAll	Brush All
BrushAll/Center	Brush No Center

TotalXpInLevel	Total XP
EdMobXP		XP: {0} (In View: {1})\nTotal XP: {2}

Normal		Normal
Down		Down
Up		Up

Quantity	Quantity
SubId		SubId
Toon		Toon
MapEdError	MapEd Error
DungeonLevel	Level
SeeOther	See Other

NbEditCell	Selected Cells: {0}/{1}

//=== Dungeon Tools
SetPartyStart	Set Party Start
DungeonName	Dungeon Name
DungeonIni	Dungeon File
SaveLevel	Save Level
LoadLevel	Load Level
SaveDungeon	Save Dungeon
LoadDungeon	Load Dungeon
BaseHeight 	Base Height
DeleteLevel	Delete Level
AddLevel	Add Level
MoveResizeLvl	Move & Resize Level
ResizeLevel	Resize Level
TestDungeon	Save & Test Dungeon
TestLevel	Save & Test Level
LevDefaultEnv	Level's Default Environment
LevAmbience	Level Ambience Track
AssignEnv	Assign Environment
DungeonVersion	Version
NewDungeon	New Dungeon

LigthOnParty	Boost Light On Party
BoostAmbient	Boost Ambient Light

LevelSaved	Level Saved to {0}
DungeonSaved	Dungeon Saved to {0}

NbLevelAround	Levels Around		//##

XpScale		XP Scale		//##

//=== Steam Workshop			//##
SteamWorkshop	Steam Workshop
SWS_CreateNew	Create New Item
SWS_UpdateItem	Update Item
SWS_Banned	You have been banned from Steam Community, so you can't add anything.
SWS_TimeOut	Connection Timed Out. Retry later (or now! ;-) ).
SWS_NotLogged	You have to log in your Steam account 1st.
SWS_Visibility	Visibility
SWS_Vis00	Public
SWS_Vis01	Friends
SWS_Vis02	Private
SWS_ChangeNotes	Change Notes
SWS_InvalidUp	Invalid
SWS_Commiting	Commiting
KilobyteSymbol	KB
AutoScreenshot	Auto-Screenshot
FromLastCamPos	From Last Camera
DownloadingMap	Downloading Dungeon
DownloadingItem	Download In Progress
ItemInQueue	Items to be downloaded
DlItemInfo	Please wait for Steam Workshop Items to finish to download.
SteamItemId	Steam Item ID

ModInDownload	The Following Mods a new Items from Steam Workshops need to be downloaded or updated, so they were not applied:{0}\n\nWait for them to finish to download, then restart the game. You can also play right away, but if these Mods are needed for your saved games, not having them might create unexpected results or crash the game.

SWS_Mods	Mods
ModDependency	You have these Mods installed : {0}\n\nIf your creation requires some of these Mods, be sure to set the correct dependencies in its Steam Workshop page that will pop up at end of the upload.
SWS_ModDetail	Workshop ID

//=== FlyBy
AddedFlyBy	Added FlyBy Point #{0}
FlyByCleared	FlyBy Cleared
FlyByEmpty	FlyBy is Empty
FlyByOnly1	FlyBy has only 1 point !
FlyDelete	D

//=== Target & Switch
Add		Add
SetTo0		Set To 0 (Untriggered)
SetTo1		Trigger
Toggle		Toggle Match
ToggleAlways	Toggle Always
SetIfTo		Set If To
SetIfToElse0	Set If To Else Reset
TimedSwitch	Timed Switch
TimedOppSwitch	Timed Invert Switch
CancelSwitch	Cancel If Switch Is
CancelDelayedS	Cancel Delayed Switch
CancelDelayedA	Cancel Delayed All
SetMobBehavior	Set Mob Behavior
AlwaysActivate	Always Activate
Cycle		Cycle
TeleportToPath	Teleport To Path
ApplyAbility	Apply Ability
SetTo		SetTo
AddBound	Add Clamp

NoConstraint	No constraint
OnlyOnActivate	Only On Activate
OnlyOnDeactivat	Only On Deactivate
Once		Once
OnceOnActivate	Once On Activate
OnceOnDeactivat	Once On Deactivate

SelectTarget	Select Target
Var1		Var1
Var2		Var2
Delay		Delay
SecondSymbol	s
Activate	Activate
Times		Times
AlwaysRepeat	Repeat
TriggeredByToon	Triggered By Party
TriggeredByMob	Triggered By Mob
TriggeredByItem	Triggered By Item
TargetInLevel	Targets In Levels
Targets		Targets
TrackMob	Track Mob

Triggered	Triggered
TriggeredBy	Triggered By
TriggeringDir	Triggering Dir
NoItemSelected	No Item Selected
OtherItemUnTrig	Other Items Prevent Triggering
TrigItemAnyNum	Any Item of that Type
TrigItemAnyLvl	Any Level
TrigItemAnySub	Any Sub Id

Found		Found
NotFound	NotFound

AutoCeilHeight	Auto Ceiling Height
CeilHeight	Ceiling Height
DownTo		Down To
Direction	Direction
MeterSymbol	m
MsSymbol	m/s		// Meters  za sekundu
ResetLast	Set To Last

TriggerValue	Trigger Value
AutoHeight	Auto Height
Height		Height
SetToLast	Set To Last
TriggerOnAggro	Trigger On Aggro
TriggerOnDeath	On Death
TriggerOnBattle	On Battle

LiftNbStop	Stops
LiftSpeed	Speed

OpenTriggered	Open (Triggered)
ClosedUntrig'ed	Closed (Untrigged)
OpenUntriggered	Open (Untriggered)
ClosedTriggered	Closed (Triggered)

ItemLoot	Odloženo příserami // Dropped by Mobs
Weight		Hmotnost
KgSymbol	Kg		// Kilograms
ItemLevel	Úroveň
ItemLevelN	Úroveň {0}
ItemLevelSymbol	Ú
ItemQuality	Kvalita
GearSlot	Slot
GearKind	Materiál
StackSize	Počet
TotalWeight	Celková hmotnost
OverWeight	Banda toho nese moc a tudíž se hýbe pomaleji, měl by ses něčeho zbavit.
CrushingWeight	Banda je zavalena lupem, pokud se něčeho nezbavíš, tak už se nepohneš z místa.

Active		Active
Inactive	Inactive
ActiveTriggered Active (Triggered)
InactUntrig'ed	Inactive (Untriggered)
InactiveTrig'ed	Inactive (Triggered)
ActiveUntrig'ed	Active (Untriggered)

DelOrClearLev	Delete Or Clear Level {0} ?
Delete		Delete
Clear		Clear
AddLev?		Add Level ?
BeforeLev	Before Level
AfterLev	After Level
AtFirst		At First
AtEnd		At End
Deleted		Deleted

1stRow		1st Row
LastRow		Last Row
1stColumn	1st Column
LastColumn	Last Column
CopyLevelExtent	Copy Level Extent
GetAutoExtent	Get Auto-Extent
MoveLevel	Move Level
MoveRow		Move Row
MoveCol		Move Column
ApplyPitChanges	Apply Pit Changes
WarnCrop	Some occupied cells are going to be destroyed. This is NOT undoable.

Floor		Floor
Ceiling		Ceiling
Wall		Wall
Corner		Columns & Prop
Prop		Wall's Prop
Mob		Mob
Item		Item
Field		Field
EditCells	Edit Cells
Dungeon		Dungeon

Undo		Undo
Redo		Redo

TotalLoot	Total Loot For Current Toon
LootInLevel	In Current Level for All Toons

//=== Edit Cells
SelectAll	Select All
SelectOnlyUsed	Only Used
SelectOnlyEmpty	Only Empty
Select		Select
Paste		Paste
Copy		Copy
Cut		Cut
NoCopiedCell	==> Copy/Cut Cells 1st <==
SelectOnPaste	Select Cells On Paste

SetCellHeight	Set Floor Height
MoveCellHeight	Move Floor Height
SetCeilingHgt	Set Ceiling Height
MoveCeilingHgt	Move Ceiling Height

//=== Field
Speed		Speed
Angle		Angle
Damage		Poškození
GenMaxTotal	Max Generated
GenMaxAlive	Max Alive
DelayAtStart	Delay At Start
OnlyNotVisible	Only When Not Visible
KillOnDisable	Kill All Generated On Disable
DialogFile	Dialogue File
EffectName	Ability
EffectContent	Visual Effect
TagField	Tag

//=== Wall
North		North
East		East
South		South
West		West
WallAuto	Auto
Center		Center
WallNoChange	No Change
WallOpposite	Opposite Dir
Pit		Pit
AllWall		All
WallLeft	Turn Left
WallRight	Turn Right

//=== Field
FieldDialog	Dialogue
FieldTrigger	Trigger Field
FieldTeleporter	Teleporter
FieldForce	Force Field
FieldEffect	Effect Field
AffectParty	Affect Party
AffectMob	Affect Mobs
AffectItem	Affect Items
TriggerRemote	Trigger On Remote Activation
TriggerNoRemote	No Trigger On Remote Activation

//=== Behavior
BhvGuard	Guard
BhvRoam		Roam
BhvPatrol	Patrol
BhvAttack	Attack
BhvFlee		Flee
BhvSleep	Sleep
BhvAmbush	Ambush

NoLimit		No Limit
MaxRoamDist	Max Roam Dist
MaxRoamLevel	Max Roam Level
RandomLoot	Random Loot

NoPathSelected	No Path Selected
CreatePath	Create New Path
ModifyPath	Modify Path
DeletePath	Delete Path
NewPathPoint	New Path Point
PathDelay	Delay
PathJumpTo	Jump To Point
DeletePathPoint	Delete Point

//=== Item
Generic		XXGeneric
Weapon		Zbraň
Gear		Vybavení
Consumable	Poživatina
Generator	XXGenerator
Key		Klíč
Projectile	Projektil
TargetedRandom	Targeted Random
ItemRandDetail	Rd Lvl:
ItemAllLvl	All
ItemAllQualites	Any Quality

//=== Key
IronKey		Železný klíč
BrassKey	Mosazný klíč
GoldKey		Zlatý klíč
EbonyKey	Ebenový klíč
EmeraldKey	Smaragdový klíč
SilverKey	Stříbrný klíč
SquareKey	Klíč se čvercem
SkullKey	Klíč s lebkou
RubyKey		Rubínový klíč
CrossKey	Klíč s křížem
AutoMap		Svitek magického mapování

//=== Weapon
WeaponKind	Druh zbraně
WeaponFist	Pěst
WeaponDagger	Dýka
WeaponSword	Meč
WeaponAxe	Sekera
WeaponMace	Palcát
WeaponPolearm	Kopí
WeaponStaff	Hůl
WeaponWand	Hůlka
WeaponBow	Luk
WeaponCrossbow	Samostříl
WeaponThrown	Vrhací
WeaponAll	Různé druhy zbraní

Hand		Ruce

PracticeSword	Cvičný meč
PracticeGladius	Cvičný římský meč
ShortSword	Krátký meč
ShortSwordB	Imperiání meč
KnightSword	Rytířský meč
GuardSword	Meč stráže
CaptainSword	Meč kapitána
BroadSword	Široký meč
NorseSword02	Severský meč
Claymore	Skotský meč
LongSword	Dlouhý meč
Flamberge	Plamenný meč
Katana01	Katana
Katana02	Zabijácká katana

FireWand	Magická hůlka - oheň

CombatKnife	Bojový nůž
Dagger		Dýka
DaggerB		Imperiální dýka
DaggerC		Dlouhá dýka
DaggerLarge	Velká dýka

WoodmanAxe	Lesnická sekera
FellingAxe	Dřevorubecká sekera
BattleAxe	Bojová sekera
DoubleAxe	Oboustranná sekera
Sagaris		Sagaris
WarAxe		Válečná sekera
BarbarianAxe	Barbarská sekera

Halberd_A	Halapartna
Halberd_B	Ocelová halapartna

Staff		Runová hůl
StaffSylvan	XXSylvan hůl
StaffIron	Železná hůl
StaffBent	Tvarovaná hůl

StoneHammer	Kamenné kladivo
Mace01		Křídlatý palcát
Mace02		Palcát
WarHammer	Válečné kladivo
Flail		Řemdih

Bow		Luk
Crossbow	Samostříl

//=== Generic
Stone01		Malý oblý kámen
Stone02		Temný kámen
Stone03		Malý hnědý kámen
Stone04		Prasklý malý kámen
Stone05		Oblázek
StoneHeavy	Neskutečně těžký malý kámen

Urn-DM1		"<i>Popel Bluegoldův</i>"
Urn-DM2		"<i>Popel Notwena Reklawa</i>" // nice Walter N ;)
Urn-DM3		"<i>Popel Redloha Soraje</i>" // Holder ;)

IdolTiger	Soška tygra
IdolSnake	Soška hada
IdolPrimitive	Primitivní soška

PulsingAmethyst	Pulzující ametyst
PulsingEmerald	Pulzující smaragd
PulsingRuby	Pulzující rubín
PulsingSapphire	Pulzující safír

EmptyMap	Bezcenná prázdná mapa

//=== DpsLog
DpsTotal	C
TipDpsTotal	Celkem za {0}
DpsAverage	P
TipDpsAverage	Průměr za poslední {0}

CombatLog00	D
CombatLog01	H
CombatLog02	L
CombatLog03	T

TipCombatLog00	Škoda
TipCombatLog01	Léčení\n(včetně vstřebaných úderů)
TipCombatLog02	Ztracené zdraví\n(včetně vstřebaných úderů)
TipCombatLog03	Hrozba\n(nejvyšší aktualní hrozba)

MinuteSymbol	m
TipCombatPeriod	Celá doba
TipCombatAvrg	Průměrná doba
TipCombatBack	Ukaž předchozí

Threat		Hrozba

//=== Notes
Note		Poznámka
NoteTip		Poznámka, která zní:\n"<i>{0}</i>"
NoteL01-01	Rád[P:|a] se honíš za poklady ? Pokud ano, tak mě u nějakého odlož...
Skull		Lebka
StrangeSkull	Podivná lebka
NoteL08-01	Jsi si jist[P:ý|á] kdo je tu lovcem a kdo štvanou zvěří ?
NoteL09-01	Cítíš se osaměle ?\n\nNemusíš.\n\nJÁ Tě pozoruju ... POŘÁD.
NoteL13-01	Jsem ztracen. Nevím, kde mi hlava stojí. Pomozte mi se najít.	// Note beside a Skull in an alcove
NoteL13-02	Není cesty zpět ... nikdy nebylo.
NoteL13-03	Naštěstí pro Tebe neovládám telepatii, jinak už bych Ti dávno nakukal[P:a|], že jsem [P:Tvoje|Tvůj], chtěl[P:a|] po Tobě hromadu náročnejch úkolů, jen abys nakonec zjistil[P:|a], že jsem [P:Tvůj|Tvoje] největší ne-přítel[P:kyně|].\n\nTo by byl nečekanej zvrat, co ?
NoteL14-01	Každý krok vpřed Tě jen přibližuje smrti.
NoteL15-01	Myslíš si, že jsi strážce podzemí ? Jedině JÁ jsem ten pravý Strážce podzemí.
NoteL15-02	Zrovna jsem se vrátil z knihovny, četl jsem tam knížku o proroctví a na něco jsem přišel : Ty seš Vyvolen[P:ej|á] ! Povolali Tě, abys vnesl[P:|a] světlo do tohoto doupěte temnoty a navždy ho zbavil[P:|a] toho největšího nejčernějšího zla.\n\nUž teď se třesu strachy. Naštěsetí v tý knížce je dalších, bratru, 4000 proroctví, jedno lákavější než druhé.\n\nMě zaujalo tohle - Až prasata budou lítat, slépky budou zuby mít - řek bych, že se tohle stane dřív, co říkáš ? Mlčís ?
NoteL16-01	Vítej v mém prostém domě.\n\nUdělej si pohodlí, budeš tu pěkně dlouho.\n\nAbych byl přesný - věčnost.
NoteL16-02	Uhádneš, kdo jsem ?\n\nNápověda : Nemám 6 stran, jen 3.	// 6 Faces for the Cube boss of LoG1
NoteL17-01	Stejně jako můj táta ani Ty tu nevydržíš dlouho.
NoteL18-01	Pojďte ke mě zlatíška. Ja rád zlatíška.
NoteL18-02	Jsme jako spojené nádoby - Tvůj pád bude můj vzestup.
NoteL19-01	Nečekal jsem, že se dostaneš až sem...\n\nKecám, čekal jsem  ! Proč jinak by tu byla tahle poznámka ?!?\n\nZemřeš, kdy jen si budu přát. Tak si pomalu chystej poslední slova. Protože já pro Tebe žádná mít nebudu.
NoteL19-02	Přinesl[P:|a]s si Ohnivou hůl ?\n\nNe? To je dobře, stejně by Ti byla k ničemu. Mrtví většinou nepotřebují vůbec žádné hole.	// Firestaff from Dungeon Master
NoteL20-01	Smrt nevyzkoušíš.		// Yoda (if you ask "Yoda who ?", you're out of here ! ;-) )
NoteL20-02	Konečně nastal ten čas - přeješ si rychlou či pomalou smrt ?

//=== Gear Leather
GuardChest	Strážcova zbroj // hrudní plát
GuardLeggings	Strážcovy legíny
GuardBoots	Strážcovy boty
GuardGloves	Strážcovy nátepníky
GuardHelmet	Strážcova helma

//=== Gear Mail
CaptainChest	Kapitánova zbroj // hrudní plát

//=== Gear Plate
ChampionChest	Šampionův hrudní plát
ChampionLeggings	Šampionovy legíny
ChampionBoots	Šampionovy boty
ChampionGloves	Šampionovy rukavice
ChampionHelmet	Šampionova helma

//=== Gear Other
//GuardShield	Strážcův štít
//ChampionShield	Šampionův štít
CloakMage	Plášť
CloakWarrior	Kápě

ShieldA		Pukléř
ShieldB		Malý štít
ShieldC		Štít
ShieldD		Velký štít // Pavéza

//=== Gear Trinket
ShellHorn	Kousek rohoviny
Trinket1	Kovová cetka
Trinket2	Stříbrná cetka

//=== Gear Cloth
PaddedRobe	Podšitá košile
PaddedLeggings	Podšité legíny
PaddedShoes	Prošívané boty
PaddedGloves	Prošívané nátepníky
PaddedHood	Čelenka

//=== Ring
Ring		Prsten
RingA1		Stříbrný prsten s rubínem
RingA1b		Stříbrný prsten s ametystem
RingA2		Hadí prsten
RingA3		Prsten s diamantem
RingA4		Platinový prsten se smaragdem
RingB1		Stříbrný hadí prsten
RingB1b		Stříbrný prsten se smaragdem
RingB2		Prsten s rubínem 
RingB3		Prsten s ametystem
RingB4		Platinový prsten se safírem

//=== OffHand
Book1a		Kniha
Book1b		Spisek
Book2		Kodex
Book3		Bichle

//=== Necklace
Necklace1	Hadí amulet
Necklace2	Runový amulet
Necklace3	Rubínový náhrdelník
Necklace4	Smaragdový náhrdelník
Necklace5	Zlatý amulet
Necklace6	Platinový amulet
Necklace7	Ametystový náhrdelník
Necklace8	Safírový náhrdelník

//=== Consumable
HealthPotion01	Léčivá ampule
HealthPotion02	Malý léčivý lektvar
HealthPotion03	Střední léčivý lektvar
HealthPotion04	Velký léčivý lektvar
HealthPotion05	Obří léčivý lektvar	// Next: Master, then Minor/Lesser/... Healing Elixir, etc...

ManaPotion01	Ampule s manou
ManaPotion02	Malá mana
ManaPotion03	Střední mana
ManaPotion04	Velká mana
ManaPotion05	Obří mana	// Next : Mana Elixir

HastePotion01	Ampule spěchu
HastePotion02	Nápoj spěchu
HastePotion03	Velký nápoj spěchu

CritPotion01	Ampule ráznosti
CritPotion02	Nápoj ráznosti
CritPotion03	Velký nápoj ráznosti

//=== Item Slot
SlotHead	Helmice
SlotNeck	Náhrdelník
SlotShoulder	Kápě
SlotChest	Zbroj
SlotBack	Plášť
SlotWrist	Nátepníky
SlotHands	Rukavice
SlotWaist	Chrániče
SlotLegs	Kalhoty
SlotBoots	Boty
SlotMainHand	Zbraň
SlotOffHand	Štít // Štít / Zbraň
SlotRing	Prsten
SlotTrinket	Cetka
SlotAltWeapon	Záložní zbraň
SlotAll		Všechna místa / Libovolné místo
EmptySlotFor	Sem patří {0}

//=== Gear Kind
GearApparel	Oblečení
GearCloth	Látka
GearLeather	Kůže
GearMail	Kroužků
GearPlate	Ocel
GearOther	Jiný materiál
GearAll		Všechny materiály / Libovolný materiál

//=== Item Quality
QualityGarbage	Odpad
QualityCommon	Běžná
QualitySuperior	Vynikající
QualityRare	Neobvyklá
QualityEpic	Epická
QualityLegendary	Legendární
QualityAll	Všechny / libovolná kvalita

// {0} = base item name (eg: guard sword)
NameGarbage	{0} (rozpadající se)
NameCommon	{0} (běžné kv)
NameSuperior	{0} (vynikající kv)
NameRare	{0} (neobvyklé kv)
NameEpic	{0} (epické kv)
NameLegendary	{0} (legendární kv)

//=== Game
TargetUncons	Cíl omdlel
TargetConscious	Cíl je už připraven // Target is not Unconscious
CantCastOnU	Tohle na sobě vyzkoušet nemůžeš
NotEnoughMana	Málo many
QueueFull	Plná fronta
NoTarget	Nevybrán protivník
CantInterrupt	Toto přerušit prostě nejde
NeedRangedWp	Tato dovednost vyžaduje střelnou zbraň
NeedMeleeWp	Tato dovednost vyžaduje chladnou zbraň
AbRequireWp	Tato dovednost vyžaduje: {0}
Overweight	Banda toho nese moc a tudíž se hýbe pomaleji, měl by ses něčeho zbavit. // X2!
PartyStunned	Banda se nemůže hýbat : všichni jsou ochromeni !
NoSpec		Tak tenhle popisek někdo regulérně ukrad ! // Still No Spec for this Toon's Class - Work in Progress !
// XX
Casting		Casting
NotFighting	Tato postava nemá protivníka,\ntakže aktuálně nebojuje
StunnedCantDo	Jsem ochromen[P:|a], takže teď neudělám vůbec nic !
WIP		Musíme to opravit :D - Pokud Bůh aktualizací dá, tak přístě je to tam ...

//=== Level Names
Level01		Zapomenutý žalář // Forgotten Jail
Level02		Podzemní pevnost // Deep Fortress
Level03		Katakomby otroků // Slave Catacombs
Level04		Zapovězená kaple // Forsaken Chapel
Level05		Opuštěná hala // Abandoned Hall
Level06		Imperiální bydlení // Imperial Quarters
Level07		Aréna // Battle Arena
Level08		Vstup do jeskyně // Cave Entrance
Level09		Podzemní les // Underground Forest
Level10		Temné jeskyně // Dark Caverns
Level11		Ztracený důl // Lost Mines
Level12		Tisíc jesknyní // Thousand Caverns
Level13		Mrtvý palác // Dead Palace
Level14		Šilencův předpokoj // Madness Antechamber
Level15		Pekelná pec // Furnace of Doom
Level16		Dračí zámek // Temple of the Dragon
Level17		Vež goblinů // Goblins' Tower
Level18		Zapovězené brány // Forbidden Gates
Level19		Nejtemnější krypta // Black Crypt
Level20		Strážcovo srdce // Guardian's Heart

//=== Notification
AddedToKeyRing	{0} přidán na kruh s klíči
LevelAutoMapped	Automatická mapa povolena pro patro {0}
LevelFullMapped	Plná mapa zpřístupněna pro patro {0}
PutInInventory	{0} přidáno do inventáře
LookLikeCanHold	Vypadá to jako nějaký držák...
CantHoldThat	Ale na tohle asi ne...
UsedKey		Použit {0}
NoMatchingKey	Nemám vhodný klíč
LevelUp		{0} právě povýšil na {1} !
GotXp		Získal[:|a] {0} bodů
XpMobKill	Získal[:|a] {0} bodů za zabití {1} úrovně {2}
Screenshot	Screenshot uložen do {0}

//=== Combat Event
CeTooFar	Příliš daleko
CeMiss		Těsně vedle
CeDodged	Uhnul
CeParried	Odražen
CeDeflected	Odkloněn
CeImmune	Neúčinné


//=== Role
Role		Role
RoleTank	Tank
RoleHealer	Léčitel
RoleDps		Útočník
RoleSpellDps	[>RoleDps]
RoleStrDps	[>RoleDps]
RoleAgiDps	[>RoleDps]
RoleStrTank	[>RoleTank]
RoleAgiTank	[>RoleTank]
RoleRangedDps	[>RoleDps]

//=== Dialog
DialogSkip	Přeskočit
DialogNext	Dále
NoChatLog	Pořád ani slůvko
ClickOnLog	Klikni na záznam v logu\na uvidíš podrobnosti.

SkipIntro	Přeskočit úvod

//=== Mob Family & Genus
FamBeast	Bestie
FamCritter	Příšerka
FamDemon	Démon
FamDragonkin	Drak
FamElemental	Elementál
FamGiant	Obr
FamHumanoid	Humanoid
FamMechanical	Stroj
FamUndead	Nemrtvý
FamUnknown	Neznámo

GenCommon	Běžný
GenElite        Elita
GenRare         Vzácný
GenRareElite    Vzácná elita
GenBoss         Boss

//=== Mobs
MobSkeleton	Kostlivec
MobSkeletonMinion	Kostlivcův pomocník
MobSkeletonMage	Kostlivec - mág
MobSkeletonArcher	Kostlivec - lučíštník
MobSkeletonFootman	Kostlivec - pěšák
MobSkeletonWarlord	Kostlivec - bojovník
MobSkeletonSoldier	Kostlivec - voják
MobSkeletonChampion	Kostlivec - šampion
MobSkeletonVeteran	Kostlivec - veterán
MobAncientKnight	Starobylý rytíř
MobSkeletonCaptain	Kostlivec - kapitán
MobSkeletonKing		Kostlivec - král
MobSkeletonKnight	Kostlivec - rytíř
MobSkeletonLieutenant	Kostlivec - poručík
MobCaveWorm	Jeskynní červ
MobEvilWatcher	Ďáblovo oko
MobChaosWatcher	Oko chaosu
MobSpider	Pavouk
MobSpiderLing	Pavouček
MobSpiderQueen	Královna pavouků
MobBonesDragon	Drak - kostlivec
MobThief	Smrtící stín
MobUndeadKing	Nemrtvý král
MobCaveMonster	Jeskynní bestie
MobCaveMother	Jeskynní bestie - matka
MobForsakenKnight	Zapovězený rytíř
MobGoldenKnight	Zlatý rytíř
MobArmoredBarbarian	Obrněný barbar
MobBarbarianHulk	Barbarian - kopiník
MobBarbarianDestroyer	Barbar - ničitel
MobBarbarianLeader	Barbar - šéf
MobBarbarianUnderworld	Temný barbar
MobBarbarianSpike	Ostnatý barbar
MobImperialKnight	Imperiální rytíř
MobImperialGuard	Imperiální stráž
MobImperialMinistrel	Imperiální bard
MobBarbarianSlave	Barbar - otrok
MobBarbarianSlaver	Barbar - otrokář
MobBigBoss	Strážce podzemí
MobCaveVampire	Jeskynní upír
MobArcher2	Královský lučištník
MobArcher2-Light	Jasný avatar
MobArcher2-Shadow	Temný avatar
MobRoyalKnight	Imperiální poručík
MobWarrok	Warrok
MobBarbarianWarrior	Barbar - válečník
MobMushroomSmall	Agresivní houba
MobMushroomBig	Pekelná houba
MobCaveTroll	Jeskynní trol
MobSnake	Had
MobSnakeLing	Hádě
MobSnakeKing	Král hadů
MobDragonBat	Netopýr dračí
MobDragonBatPup	Netopýrek dračí
MobDragonVampire	Drak - upír
MobWormCave	Jeskynní červ
MobWormDragon	Dračí červ
MobCavePredator	Jeskynní predátor
MobCavePatriarch	Jeskynní vládce
MobGnomeWorker	Gnóm - dělník
MobGnomeWarrior	Gnóm - bojovník
MobGnomePriest	Gnóm - kněz
MobGnomeArcher	Gnóm - lučištník
MobGnomeGiant	Gnóm - obr
MobGnomeGiant2	Gnóm - obr
MobGnomeProtector	Gnóm - ochránce
MobElvenWitch	Elf - čarodejnice
MobElvenHunter	Elf - lovec
MobElvenAssassin	Elf - vrah
MobElvenSwordGuard	Elf - šermíř
MobElvenSpearGuard	Elf - kopiník
MobElvenBeast	Elfí bestie
MobElvenBeastArmored	Obrněná elfí bestie
MobElvenQueenBeast	Elvfí královna - bestie
MobElvenQueen	Elfí královna
MobSnakeMinion	Had - pomocník
MobGolemSoldier	Golem - voják
MobGolemCrusher	Golem - drtič
MobGolemGuard	Golem - stráž
MobGolemMage	Golem - mág
MobGolemAssassin	Golem - vrah
MobGolemArcher	Golem - lučištník
MobRatkinWarrior	Krysák - bojovník
MobRatkinGunner	Krysák - střelec
MobRatkinShaman	Krysák - šaman
MobRatkinSlave	Krysák - otrok
MobRatkinWarlord	Krysák - hrdina
MobTrollWarrior	Trol - bojovník
MobCyclops	Kyklop
MobLizardman	Ještěr
MobOrcGrunt	Ork - mrzout
MobOrcBrute	Ork - nelida
MobWarlock	Bojový mág
MobPigHead	Prasečí hlava
MobEmissary	Vyslanec
MobDragon	Drak
MobDragonIce	Ledový drak
MobMinionCrusher	XXMinion - drtič
MobMinionGuard	XXMinion - stráž
MobMinionAssassin	XXMinion - vrah
MobGoblinBandit	Goblin - bandita
MobGoblinBaron	Goblin - baron
MobGoblinGladiator	Goblin - gladiátor
MobGoblinShaman	Goblin - šaman
MobGoblinSlave	Goblin - otrok
MobSoulEater	Požírač duší
MobSoulDevourer	Lovec duší
MobSoulCrusher	Ničitel duší
MobDemonWarrior	Démon - bojovník
MobDragonBugTiny	Malý dračí brouk
MobDragonBug	Dračí brouk
MobDragonBugGiant	Velký dračí brouk
MobGargoyle	Chrlič
MobGargoyleLesser	Malý chrlič
MobGargoyleBanished	Zapovězený chrlič
MobBasilisk	Bazilišek
MobBasiliskLesser	Vodní bazilišek
MobBasiliskGreater	Popelavý bazilišek
MobWyvern	Saň
MobWyvernElder	Stará saň
MobSorceress	Čarodějka
MobNightshade	Stín noci
MobDemonist	Pekelník
MobBigBoss1	Strážce podzemí
MobBigBoss2	[>MobBigBoss1]
MobBigBoss3	[>MobBigBoss1]
MobBigBoss4	[>MobBigBoss1]
MobEmperorGhost	Imperátorův duch
MobJanitor	Žalářník
MobWarden	Správce vězení

//=== Races
RaceHuman	Člověk
RaceDwarf	Trpaslík
RaceElf		Elf
RaceDarkElf	Temný elf
RaceHalfling	Půlčík

DescRaceHuman	Lidé jsou nejběžnější rasou v těchto končinách a kupodivu mají silnou vůli.
DescRaceDwarf	O co jsou trpaslící menší o to jsou silnější. Užívají si život v podhůří.
DescRaceElf	Elfové jsou dětmi lesa, moudří, ale uzavření.
DescRaceDarkElf	O temných elfech se říká, že jsou batři elfů, kteří se nechali svést temnou magií a žijí v podzemí.
DescRaceHalfling	Půlčíci sice vypadají jako malí, slabí lidé, ale opak je pravdou - jsou krajně čilí.

//=== Sex
SexGender	[:Muž|Žena]

//=== Default Names
CharName01	[:Honza|Matylda]
CharName02	[:Elifelet|Aurora]
CharName03	[:Tatius|Medúza]
CharName04	[:Ewald|Emilka]
CharName05	[:Čeněk|Hilda]

//=== Classes
ClassWarrior	Bojovník
ClassHealer	Léčitel
ClassMage	Mág
ClassRogue	Zloděj

DescClassWarrior	Bojovníci jsou tvorové první linie, kosící nepřátele a bránící přátele.
DescClassHealer	Léčitelé se starají o celou bandu, ale hlavně o Tanka.
DescClassMage	Mágové užívají svých tajemných sil k boji z dálky.
DescClassRogue	Zloději využívají taktiku k překvapení nepřátel a ochraně přátel.


//=== Hand Wielding
Wielding	Úchop
HandMain	Pravou rukou
HandOff		Levou rukou
HandAny		Libovolnou rukou
HandBastard	Bastard
HandBoth	Obouruční
HandAll		Libovolný

//=== Character Sheet
ArmorRating	Obrana // Hodnocení zbroje
TotalRating	Celkem // Celkové hodnocení
RateVsLvl	vs nepřítel úrovně {0}
RateVsBoss	vs boss
DamagePerSecond	DPS (poškození za sekundu)
Experience	Zkušenosti
ToonLevel	Úroveň
WarnEquipCombat	Během boje nelze měnit zbraně
GearRestricted	Tahle věc není pro vybranou postavu vhodná
BaseBonus	Základ: {0}\nBonus: {1}
BaseMalus	Základ: {0}\nHandicap: {1}

//=== Attributes
Str		Síla // Strength
Agi		Agilita // Agility
Awa		Pozornost // Awareness
Wil		Síla vůle // Willpower
Sta		Odolnost // Stamina
HP		Zdraví // Health
HpRegn		Uzdravování
HpCbRegn	Uzdravování v boji
Mana		Mana
ManaRegn	Obnova many
ManaCbRg	Obnova many v boji
AP		Síla útoku
RAP		Síla vzdáleného útoku
SP		Síla kouzla
Parry		Odražení
Dodge		Úhyb
Block		Blokování
Armor		Brnění
ResNat		[>DmgNature]
ResArcan	[>DmgArcane]
ResFire		[>DmgFire]
ResFrost	[>DmgFrost]
ResShad		[>DmgShadow]
ResHoly		[>DmgHoly]
ResFall		[>DmgFall]
Crit		Šance na kritický zásah (šnkz)
mCritX	 	Násobek šnkz
rCritX	 	Násobek šnkz na dálku
sCritX	 	Násobek šnkz kouzla
Haste		Spěch
Hit		Šance na zásah
Xpertise	Expertýza
XP		XP (zkušenost)
WpDps		DPS (poškození za sekundu)
WpSpeed		Rychlost
WpDamage	Poškození

// XX
AttGeneral	General
Att1st		Attributes
AttMelee	Melee
AttRanged	Ranged
AttSpell	Spell
AttDefense	Obrana
AttResistance	Odolnost

StrTip		Zvyšuje sílu úderu při boji zblízka a sílu odražení útoku.
AgiTip		Zvyšuje sílu útoku zblízka i na dálku, šanci na kritický zásah a úhyb.
AwaTip		Zvyšuje sílu kouzel, přidává manu a přidává body do expertýzy.
WilTip		Zvyšuje množství many, rychlost obnovy many, odolnost proti magii a schopnost blokovat útok.
StaTip		Zvyšuje zdraví, zrychluje uzdravování a obnovu many (mimo boj).

HPTip		Když klesne na 0, postava omdlí.
ManaTip		Hodí se při kouzlení.
RegenTip	Obnova many a uzdravování probíhají jednou za 5 vteřin.

APTip		Zvyšuje poškození chladnými zbraněmi a dovednostmi založenými na chladných zbraních.
RAPTip		Zvyšuje poškození střelnými zbraněmi a dovednostmi založenými na střelných zbraních.
SPTip		Zvyšuje sílu všech kouzel.
DpsTip		Průměrné poškození za sekundu - pouze pro automatické útoky.\n\nBere v úvahu šanci na zásah, šanci na kritický zásah (šnkz), spěch a expertýzu.

ParryTip	Šance na odražení útoku chladnými zbraněmi.\nÚspěšné odražení obvykle znamená zrušení celého útoku.
DodgeTip	Šance na úhyb před útokem chladnými zbraněmi.\nÚspěšný úhyb se rovná vyhnutí se celému útoku.
BlockTip	Šance na blokování útoku chladnými zbraněmi štítem.\nÚspěšné blokování snižuje poškození o 30%.
ArmorTip	Snižuje poškození z fyzických útoků.

ResNatTip	Snižuje poškození způsobené na přírodě založenými útoky.
ResArcanTip	Snižuje poškození způsobené na tajemnu založenými útoky.
ResFireTip	Snižuje poškození způsobené na ohni založenými útoky.
ResFrostTip	Snižuje poškození způsobené na mrazu založenými útoky.
ResShadTip	Snižuje poškození způsobené na temnotě založenými útoky.
ResHolyTip	Snižuje poškození z posvěcených útoků.

CritTip		Každý útok, ať už automatický nebo pomocí dovednosti, má takto vysokou šanci stát se kritickým.

// XX
mCritXTip	Damage multiplier on melee critical hit.
rCritXTip	Damage multiplier on ranged critical hit.
sCritXTip	Damage multiplier on spell critical hit.

HasteTip	Zvyšuje rychlost použití dovedností a všechny efekty vázané na čas.\n\nTaké snižuje [:GlobalCD], nikoli však pauzu mezi dovednostmi - ta je pevně zafixovaná na 6 sekundách.
HitTip		Zvyšuje šanci zasáhnout cíl využitím dovedností.
XpertiseTip	Snižuje šanci na odražení.\nMaximální použitelná míra je 5%, protože i maximální šance na odražení je 5%.
ExperienceTip	Když postava dosáhne požadovaného množství bodů, pak se jí zvýší úroveň.

GlobalCD	Globální pauzu

CharStats	Statistika
CharStat00	Počet omdlení // Fallen Uncounscious
CharStat01	Největší zásah
CharStat02	Nejvyšší DPS za 12s
CharStat03	Zabito nepřátel

NoRaceBonus	Bez bonusu

//=== Map
NoMap		Mapu pro toto patro se ještě nepodařilo najít
LevelN		Patro {0}
MapNextLevel	do patra {0}

// XX
//=== Abilities ====================================================================
AbManaCost	Mana Cost: {0} MP
AbSpeed		Cast: {0}
AbChanneled	Channeled
AbCD		Cooldown: {0}
AbCDleft	Available in: {0}
WeaponBased	Weapon Based
AbRangeDist	Dostřel: {0} m
AbMeleeRange	V dosahu zbraní
AbAoeRange	Area of Effect: {0} m
AbDamageType	Typ poškození: {0}
AbTimeleft	Time Left: {0}
AbSecond	second
AbSeconds	seconds
AbMinute	minute
AbMinutes	minutes
AbAutoAttack	Auto-Attack
AbNoCombat	Cannot use during combat
OnlyOneTarget	Can affect only one target at once
PartyCD		(shared with party)
MobTarget	Target
Owner		Owner

AbRequire	Requires
WeaponTip	{1} {0}		// {1} = Hand ; {0} = Weapon Kind
AllExceptTip	All weapons except

AbInstant	Instant
AbNoQueue	Bypass Queue

DmgPhysical	Physical
DmgNature	Nature
DmgArcane	Arcane
DmgFire		Fire
DmgFrost	Frost
DmgShadow	Shadow
DmgHoly		Holy
DmgFall		Fall
DmgWeapon	Weapon Based

// {0} = Damage / Healing
// {1} = Total Dot Damage / Healing
// {2} = Total Dot Length
// {3] = Dot End Damage / Healing
// {4} = MaxStack
// {5} = Effect Modifier #1
// {6} = AoE Projectile Max Damage
// {7} = Good Color Opening Tag	// Closing Tag = </color>
// {8} = Bad Color Opening Tag
// {9} = Effect Modifier #2
// {10} = Effect Modifier #3
// {11} {12} {13} = Effect Modifier #1 raw value (ie: not formatted & colored string)

//ChTip<AbName> => {0} Charge A ; {1} Charge B

//=== Mage - Elementalist
AbFirebolt	Firebolt
DescFirebolt	Throws a bolt of fire, damaging target for {0} HP.

AbFireball	Fireball
DescFireball	Throws a big ball of fire, exploding on contact, damaging target for {0} HP, a also damaging surrounding enemies up to {6} HP.

AbScorch	Scorch
DescScorch	Scorches the target for {0} HP plus {1} HP over {2}.

AbIgnite	Ignition
TickIgnite	Burns the target for {1} HP over {2}.

AbRainOfFire	Rain Of Fire
DescRainOfFire	Burns enemies around the target for {1} HP.

AbWaterShield	Water Shield
DescWaterShield	Summons a water shield that surrounds you a absords {5} of all incoming poškození for {2}.

AbIceShield	Ice Shield
DescIceShield	Summons an ice shield that surrounds you a absorbs {5} of all incoming poškození for {2}.

AbFrostbolt	Frost Bolt
DescFrostbolt	Sends a bolt of ice that damages the target for {0} HP.

AbFocus		Focus
DescFocus	Restores {7}25%</color> of your total Mana.

AbIceblast	Ice Blast
DescIceblast	Instantly damages the target for {0} HP.

AbFlashFreezing	Flash Freezing
DescFlashFreezing	Snižuje [>Haste] by {5} for {2}.

AbCauterize	Cauterize
DescCauterize	Burns for {1} HP over {2}.

//=== Mage - Warlock
AbTorment	Torment
DescTorment	Damages the target for {1} HP over {2}.

AbShadowBall	Shadow Ball
DescShadowBall	Damages the target for {0} HP.

AbDirePlague	Dire Plague
DescDirePlague	Damages the target for {1} HP over {2}. The poškození is bigger with time.

AbHellFire	Hell Fire
DescHellFire	Damages all surrounding enemies for {1} HP.

AbDominate	Dominate
DescDominate	Damages the target for {0} HP, a raises by {5} all poškození of your periodical spells affecting the target for {2}.

AbDrainLife	Drain Life
DescDrainLife	Damages the target for {1} HP, a heals you for the same amount.

AbLethalEmpowerment	Lethal Empowerment
DescLethalEmpowerment	Damages yourself for {0} HP, a restores your Mana for the same amount.

AbDemonicForm	Demonic Form
DescDemonicForm	Transforms yourself into a demon for {2}, which zvyšuje all your physical poškození by {5} a your shadow poškození by {9}, a also snižuje all incoming poškození by {10}.

//=== Mage - Arcanist
AbArcaneRupture	Arcane Rupture
DescArcaneRupture	Damages the target for {1} HP over {2}. Stack up to {4} times.

AbArcaneBurst	Arcane Burst
DescArcaneBurst	Throws a series of deadly projectiles damaging the target for {1} HP.

AbArcaneFusion	Arcane Fusion
DescArcaneFusion	Damages the target for {1} HP over {2}. Stack up to {4} times.

AbArcaneArmor	Arcane Armor
DescArcaneArmor	Raises armor by {5}% for {2}.

AbArcaneLock	Arcane Lock
DescArcaneLock	Locks the target so they won't be able to attack for {2}. Damaging the target for {5} HP will break the lock. Can't be used against Elite & Boss enemies.

AbMindFocus	Mind Focus
DescMindFocus	Raises an ally's Critical chance by {5}% for {2}. If the ally critically hits, your chances to critically hit are also raised by {5}% for <color=white>12 seconds</color>.

AbTwinFocus	Twin Focus
DescTwinFocus	Raises Critical chance by {5}% for {2}.

AbOverCharge	Overcharge
DescOverCharge	Raises all your arcane based poškození by {5} but all your spells' mana cost is also raised by {9}. Lasts {2}.

AbEthericEnergy	Etheric Energy
DescEthericEnergy	Snižuje Mana cost of all your spells by {5} for {2}.

AbArcaneImplosion	Arcane Implosion
DescArcaneImplosion	Damages the target for {0} HP. The poškození is increased by {8}100%</color> for each stack of [>AbArcaneRupture] currently on the target.\n\nConsumes [>AbArcaneRupture].

AbEsotericConnection	Esoteric Connection
DescEsotericConnection	Raises poškození of the whole party by {5} for {2}.

AbTotalRupture	Total Rupture
DescTotalRupture	Resets the duration of your [>AbArcaneRupture] afflicting the target.

//=== Healer - Druid
AbHeal		Heal
DescHeal	Heals a friendly target for {0} HP.

AbLifeBloom	Life Bloom
DescLifeBloom	Heals the target for {1} HP over {2}. When Life Bloom ends, the target is instantly healed for {3} HP. This effect can stack up to {4} times on the same target.

AbRegrowth	Regrowth
DescRegrowth	Heals the target for {1} HP over {2}.

AbSavior	Savior
DescSavior	Instantly heals the target for {0} HP.\n\nShare its cooldown with [>AbMortification] a [>AbOverMyDeadBody].

AbDanceOfGaia	Dance Of Gaia
DescDanceOfGaia	Heals every member of the group by {1} HP.

AbWildRegrowth	Wild Regrowth
DescWildRegrowth	Heals the target for {1} HP over {2}.

AbDanceOfStars	Dance Of Stars
DescDanceOfStars	Heals the target for {1} HP over {2}.

AbRegrowthMana	Nature Gives Back
DescRegrowthMana	Regenerates {1} Mana over {2}.

AbRainOfLife	Rain Of Life
DescRainOfLife	Heals every member of the group for {1} HP over {2} ; the healing effect is stronger at start, a fades after that.

AbTreeForm	Tree Form
DescTreeForm	Transforms you into a tree for {2} which zvyšuje all healing done by {5} a snižuje all poškození taken by {9}.

AbDruidDispel	Dispell
DescDruidDispel	Removes one negative effect from the target.\nClick on the effect you want to remove or click on an ally's portrait to remove the last negative effect applied.

//=== Healer - Priest
AbRitualRecover	Ritual Recover
DescRitualRecover	Restores all your Mana.

AbRighteousShield	Righteous Shield
DescRighteousShield	Shields the target a absorbs up to {5} damages. Lasts {2}.
ChTipRighteousShield	\n\nCan still absorb up to {0} poškození.

AbFlashHeal	Flash Heal
DescFlashHeal	Quick but expensive spell that heals the target for {0} HP.

AbRenew		Renew
DescRenew	Heals the target for {1} HP over {2}.

AbSacrament	Sacrament
DescSacrament	Heals the target for {1} HP.

AbTwinHeal	Twin Heal
DescTwinHeal	Heals the target for {0} HP a yourself for {5} of that amount.

AbDivineGrace	Divine Grace
DescDivineGrace	Raises healing done by {5} for {2} ; this effect can stack up to {4} times.

AbSacredNova	Sacred Nova
DescSacredNova	Heals the whole party for {0} HP.

AbPrayerOfRedemption	Prayer Of Redemption
DescPrayerOfRedemption	Heals the whole party for {0} HP.

AbMortification	Mortification
DescMortification	Reduces all poškození by {5} for {2}. Castable when stunned.\n\nShare its cooldown with [>AbOverMyDeadBody] a [>AbSavior].

AbHolyDiligence	Holy Diligence
DescHolyDiligence	Raises [>Haste] by {5}{7}%</color> for {2}.

AbSpiritualEffervescence	Spiritual Effervescence
DescSpiritualEffervescence	Absorbs up to {5} poškození. Lasts {2}.
ChTipSpiritualEffervescence	[>ChTipRighteousShield]

AbArchangelWatch	Archangel Watch
DescArchangelWatch	Snižuje poškození by {5} for {2}.

AbBlessedSpirit	Blessed Spirit
DescBlessedSpirit	Heals the target for {9} HP the next time they take poškození. When the healing occurs, [>AbBlessedSpirit] jumps to another random ally.\nJumps up to 5 times a lasts {2} after each jump.\n\nYou can have only 1 active [>AbBlessedSpirit].

//=== Healer - Necromancer
AbSealOfNecromancy	Seal Of Necromancy
DescSealOfNecromancy	The ally marked by this seal will receive healing from some of the [>SpecNecromancer]'s abilities. Lasts {2} a heals for {3} HP when ending.

AbQuietSpirit	Call of the Quiet Spirit
DescQuietSpirit	Heals the whole party for {0} HP.

NoSealCarrier	\n\nIf there's no Seal carrier, the healing is done to you.

AbSoulSucking	Soul Sucking
DescSoulSucking Damages the target for {0} HP a heals the [>AbSealOfNecromancy] carrier for {7}triple</color> that amount.[>NoSealCarrier]

AbEatMyFlesh	Eat My Flesh
DescEatMyFlesh	Heals the target for {0} HP but damages you for {8}half</color> that amount.

AbSoulEater	Soul Eater
DescSoulEater	Damages the target for {1} HP over {2}, a heals you for {7}triple</color> that amount.

AbRaiseFromTheDead	Raise From The Dead
DescRaiseFromTheDead	Puts a mark on the target for {2}. If the target's health reaches {8}0</color> during that time, the target is healed for {5} HP plus a bonus up to {7}7</color> times bigger the longer the spell lasted.

AbArmyOfDarkness	Army Of Darkness
DescArmyOfDarkness	Heals the [>AbSealOfNecromancy] carrier for {5} HP a the rest of the party for {7}half</color> that amount.[>NoSealCarrier]

AbLastIncantation	Last Incantation
DescLastIncantation	Heals the target for {1} HP over {2}. When the incantation finishes, the [>AbSealOfNecromancy] carrier is healed for {5} HP.[>NoSealCarrier]

AbTouchOfDeath	Touch Of Death
DescTouchOfDeath	Snižuje target's [>Haste] by {5}{8}%</color> for {2}.

AbOverMyDeadBody	Over My Dead Body
DescOverMyDeadBody	Summons a spirit that surrounds you a absorbs {7}60%</color> of all poškození done to you a constantly taunts the target for {2}. Once the spirit is gone, all your threat is lowered by {7}50%</color>.\n\nShare its cooldown with [>AbMortification] a [>AbSavior].
AbOverMyDeadBodyShield	[>AbOverMyDeadBody]
DescOverMyDeadBodyShield	[>DescOverMyDeadBody]

AbFromDeathComesLife	From Death Comes Life
DescFromDeathComesLife	Heals {1} HP over {2}.

AbShadowArmy	Shadow Army
DescShadowArmy	Snižuje poškození by {5} over {2}.

AbLastBreath	LastBreath
DescLastBreath	Raises [>Haste] by {5}{7}%</color> over {2}.

//=== Warrior - Protector
AbRend		Rend
DescRend	Deeply cuts the target for {0} HP a makes them bleed for {1} HP over {2}. High threat.

AbThunderClap	Thunder Clap
DescThunderClap	Creates a wave of energy that greatly threatens all surrounding enemies, damaging them for {0} HP.

AbKick		Kick
DescKick	Interrupts the target's current ability. Noticeably threatening.

AbTaunt		Taunt
DescTaunt	Forces the target to attack you right away by raising your threat level against it to the highest one of the party.

AbDevastate	Devastate
DescDevastate	Damages the target for {0} HP, plus snižuje its armor by {5} for {2} ; this effect can stack up to {4} times.

AbLastStand	Last Stand
DescLastStand	Temporarily raises your current a maximum HP by {5} for {2}. After the effect expires, the extra health is lost.

AbSpellDeflect	Spell Deflect
DescSpellDeflect	Deflects first incoming projectile in the next {2}.

AbRageYell	Rage Yell
DescRageYell	Taunt all nearby enemies.

AbEnrage	Enraged
DescEnrage	Zvyšuje all poškození done by {5} a snižuje all poškození received by {7}5%</color> for {2}.

AbPulseWave	Pulse Wave
DescPulseWave	Propels a wave of energy causing {0} poškození a stunning all enemies standing in front for {2}. Very threatening.

AbCounter	Counter Attack
DescCounter	Zvyšuje [>Haste] by {5}{7}%</color> for {2} after each successful parry. Can stack up to {4} times.

AbShieldWall	Shield Wall
DescShieldWall	Snižuje all incoming poškození by {5} for {2}.

//=== Warrior - Man At Arms
AbSwipe		Swipe
DescSwipe	A circular attack that strikes all enemies in front for {0} HP each.

AbHardStrike	Hard Strike
DescHardStrike	A tremendous attack damaging target for {0} HP.

AbBleeding	Bleeding
DescBleeding	Target bleeds for {1} HP over {2}.

AbDeadlyAssault	Deadly Assault
DescDeadlyAssault	An expert attack based more on your Attack Power than your weapon, dealing {0} poškození to the target.

AbWarCry	Warcry
DescWarCry	Cheers all the party members a raises their Attack Power by {5} for {2}.
TickWarCry	Raises Attack Power by {5} for {2}.

AbDoomDrum	Drums of Doom
DescDoomDrum	Decreases Attack Power by {5}.

AbOverwhelmingBlow	Overwhelming Blow
DescOverwhelmingBlow	A strike damaging the target for {0} HP a lowering their parry a dodge chances by {5} for {2}.

AbMeatPounder	Meat Pounder
DescMeatPounder	[>AbSwipe] makes [>AbHardStrike] hit 1 more target for {2}.

AbLiveByTheSword	Live By The Sword
DescLiveByTheSword	Zvyšuje parry chance by {5}{7}%</color> a snižuje all poškození taken by {9} for {2}.

AbLuckyStrike	Lucky Strike
DescLuckyStrike	Zvyšuje critical chance by {5}{7}%</color> for {2}.

AbBerserk	Berserk
DescBerserk	Zvyšuje poškození done by {5} a poškození taken by {9} for {2}.

//=== Warrior - Paladin
AbDivinePunishment	Divine Punishment
DescDivinePunishment	A blast from the Gods that damages the target for {0} HP.

AbHammerOfJustice	Hammer Of Justice
DescHammerOfJustice	Empowers your weapon with the wrath of the Gods to poškození the target for {0} HP.

AbCrusaderAssault	Crusader Assault
DescCrusaderAssault	Hits the target for {0} HP a the surrounding enemies for {6} HP.

AbAngelProtection	Angel's Protection
DescAngelProtection	Surrounds the targeted ally with a protective bubble that prevents {5} poškození for {2}, but also immobilizes them. The enemies will then attack another target.

AbHolyBarrier	Holy Barrier
DescHolyBarrier	Summons a barrier that protects you against all magic poškození by {5}% for {2}.

AbHolierBarrier	Holier Barrier
DescHolierBarrier	[>DescHolyBarrier]

AbCelestialBlindness	Celestial Blindness
DescCelestialBlindness	Instantly snižuje threat against all enemies by {5}.

AbSaintlySacrifice	Saintly Sacrifice
DescSaintlySacrifice	Redirects to the [>SpecPaladin] {5} of the poškození done to the target for {2}.

AbSealOfContrition	Seal of Contrition
DescSealOfContrition	Damages the target for {1} HP over {2}.

AbSealOfRepentance	Seal of Repentance
DescSealOfRepentance	Raises all incoming attacks' critical chance by {5}{8}%</color>.

AbSpiritualShock	Spiritual Shock
DescSpiritualShock	Stuns the target for {2}.

AbSeraphicIntervention	Seraphic Intervention
DescSeraphicIntervention	Revives a fallen ally with {0} HP a protects him from all poškození for {2}.

AbNoSacrificeInVain	No Sacrifice In Vain
DescNoSacrificeInVain	Heals {3} HP after {2}.

//=== Rogue - Assassin
ComboPoint	Streak point
ComboPoints	Streak points
AddComboPoint	\n\nGrants 1 Streak point
FinishCombo	Streak Climax : consumes all Streak points.\n\n

AbDreadfulJab	Dreadful Jab
DescDreadfulJab Cunning strike that damages the target for {0} HP.[>AddComboPoint].

AbSwiftKnife	Swift Knife
DescSwiftKnife	[>FinishCombo]Throw a magical knife damaging the target for {0} HP. The poškození is increased by {8}20%</color> for each [>ComboPoint].

AbPoison	Deadly Poison
DescPoison	Damages the target for {1} HP over {2}.

AbExecute	Execution
DescExecute	[>FinishCombo]Hits the target for {0} poškození. The poškození is increased by {8}20%</color> for each [>ComboPoint].

AbMug		Mug
DescMug		Attacks with both your weapons. Your main-hand attack damages the current target for {0} HP, while your off-hand attack damages a nearby enemy.\n\nGrants 2 [>ComboPoints].

AbKillingSpree	Killing Spree
DescKillingSpree	[>FinishCombo]Zvyšuje your [>Haste] by {5}% for {2}. Each [>ComboPoint] zvyšuje the length of this effect by {7}100%</color>.

AbThousandKnives	Thousand Knives
DescThousandKnives	[>FinishCombo]Throw knives all around you, damaging all nearby enemies for {0} HP. Each [>ComboPoint] zvyšuje the poškození by {8}20%</color>.

AbHiredHitman	Hired Hitman
DescHiredHitman	Your ally will absorb {7}65%</color> of your threat for <color=white>12 seconds</color>.

AbHitman	[>AbHiredHitman]
DescHitman	Transfers to your ally {5} of all your threats for {2}.

AbHiringHitman	[>AbHiredHitman]
DescHiringHitman	Absorbs some of the threat from the [>SpecAssassin] for {2}.

AbFadeInShadows	Fade In The Shadows
DescFadeInShadows	Raises your [>Dodge] chance by {5}% for {2}.

AbNowOrNever	Now or Never
DescNowOrNever	Grants you 5 [>ComboPoints].

//=== Rogue - Duelist
AbPommel	Pommel
DescPommel	[>DescKick][>AddComboPoint].

AbSweepingBlow	Sweeping Blow
DescSweepingBlow	Damages the target for {0} HP a all the surrounding enemies for half of that. Also applies [>AbDeepCut] that will do the same poškození over <color=white>12 seconds</color>. Very threatening.[>AddComboPoint].

AbDeepCut	Deep Cut
DescDeepCut	Damages the target for {1} HP over {2}. Very threatening.

AbInvitation	Invitation
DescInvitation	Tricks the target into attacking you right away by raising your threat level against it to the highest one of the party.[>AddComboPoint].

AbSleightOfHand	Sleight Of Hand
DescSleightOfHand	Decreases Attack Power by {5}.

AbRiposte	Riposte
DescRiposte	Zvyšuje physical poškození by {5} for {2}.

AbLunge		Lunge
DescLunge	[>FinishCombo]Damages the target for {0} HP. Each [>ComboPoint] zvyšuje the poškození done by {8}30%</color>. High threat.

AbBladeDancer	Blade Dancer
DescBladeDancer	Zvyšuje [>Dodge] chance by {5}{7}%</color> a snižuje all poškození taken by {9} for {2}.

AbDualStrike	Dual Strike
DescDualStrike	Attacks with both your weapons. Your main-hand attack damages the current target for {0} HP, while your off-hand attack damages a nearby enemy, preferably one not currently attacking you. High threat.\nIf you have a shield equipped in your off-hand, then only the main attack occurs.\n\nGrants 2 [>ComboPoints].

AbRubSaltWound	Rub Salt in the Wound
DescRubSaltWound	[>FinishCombo]Extends [>AbDeepCut] by {8}1 tick</color> for each [>ComboPoint].

AbPiercingStrike	Piercing Strike
DescPiercingStrike	[>FinishCombo]Damages the target for {0} HP. Ignores armor. High threat. Each [>ComboPoint] zvyšuje the poškození done by {8}30%</color>.

AbRecovery	Recovery in Blood
DescRecovery	[>FinishCombo]Heals yourself for {1} HP over {2}. Each [>ComboPoint] zvyšuje the healing done a the effect length by {7}100%</color>.

AbSlipperyFish	Slippery Fish
DescSlipperyFish	Raises your [>Dodge] chance by {5}{7}%</color>.

//=== Rogue - Ranger
AbInstinctShot	Instinct Shot
DescInstinctShot	Damages the target for {0} HP.[>AddComboPoint].

AbSniperShot	Sniper Shot
DescSniperShot	[>FinishCombo]Damages the target for {0} HP. The poškození is increased by {8}15%</color> for each [>ComboPoint].

AbDoubleShot	Double Shot
DescDoubleShot	Damages the target for {0} HP. Also sends another projectile that damages another target nearby for {8}75%</color> of that amount.\n\nGrants 2 [>ComboPoints].

AbHemorrhage	Hemorrhage
DescHemorrhage	Damages the target for {1} HP over {2}.

AbMaimThenKill	Maim Then Kill
DescMaimThenKill	Raises poškození of [>AbSniperShot] by {5} for {2}.

AbVolleyOfArrows	Volley of Arrows
DescVolleyOfArrows	[>FinishCombo]Send a volley of arrows around the target damaging all enemies for {1} HP. The poškození is increased by {8}20%</color> for each [>ComboPoint].

AbPlayingPossum	Playing Possum
DescPlayingPossum	You pretend to die, removing all your threat against all enemies, but this stuns you for {2}.

AbSideTrack	Sidetrack
DescSideTrack	Your ally will absorb {7}40%</color> of your threat for <color=white>9 seconds</color>.

AbSideTracked	[>AbSideTrack]
DescSideTracked	Transfers to your ally {5} of all your threats for {2}.

AbSideTracking	[>AbSideTrack]
DescSideTracking	Absorbs some of the threat from the [>SpecRanger] for {2}.

AbNightOfTheHunter	Night of the Hunter	// Movie Title
DescNightOfTheHunter	Raises your [>Haste] by {5}{7}%</color> for {2}.

AbRumble	Rumble
DescRumble	Snižuje all incoming poškození by {5} for {2}, but you cannot do anything else during that period.

AbWarningShot	Warning Shot
DescWarningShot	Tricks the target into attacking you right away by raising your threat level against it to the highest one of the party.[>AddComboPoint].

AbHunterTracking	Hunter Tracking
DescHunterTracking	Leaves smoke behind you, helping you to keep track of your steps, for {2}.

//=== Field Abilities ===================================================
AbPoisonField	Poison
DescPoisonField	Poisons for {0} HP plus {1} HP over {2}.
AbFireField	Fire
DescFireField	Burns for {0} HP plus {1} HP over {2}.
AbShadowProtField	Shadow Protection
DescShadowProtField	Protects from all Shadow based poškození by {5}{7}%</color>.
AbNatureProtField	Nature Protection
DescNatureProtField	Protects from all Nature based poškození by {5}{7}%</color>.
AbLight		Light
DescLight	Surrounds the party by light for {2}.
AbHighDamage	Curse of Dark Elves
DescHighDamage	All incoming poškození is increased by {5} for {2}.
AbBigBossLevel	Soul Crush
DescBigBossLevel	Definitively snižuje your Level by 5.
AbHealField	Timed Heal
DescHealField   Heals for {3} HP after {2}.
AbHighDamager	Inner Force
DescHighDamager	All poškození is increased by {5} for {2}.
AbDarkDecay	Dark Decay
DescDarkDecay	Decays for {1} HP over {2}. Can stack up to {4} times.

//=== Mob Abilities ===================================================
AbCharge	Charge
AbMobFirebolt	Firebolt
AbMobBow	Bow
AbMobSwing	Swing
AbMobPunch	Punch
AbMobRip	Rip
AbMobWand	Wand
AbMobWandFast	[>AbMobWand]
AbMobHeal	Heal
AbMobSmash	Smash
AbMobTailJab	Tail Jab
AbMobPoisonSpit	Poisonous Spit
AbMobBlackSpit	Black Spit
AbMobBite	Bite
AbMobImpale	Impale
AbMobBackStab	Backstab
AbMobExecute	Execute
AbMobMaim	Maim
DescMobMaim	Maims the target for {2}, lowering their [>Haste] by {5}%.
AbMobDoubleSwing	Double Swing
AbMobKick	Kick
AbMobShieldBash	Shield Bash
AbMobFrostbolt	Frost Bolt
DescMobFrostbolt	Sends a bolt of ice that snižuje its target's [>Haste] by {5}% for {2}.
AbMobSwipe	Swipe
DescMobSwipe	Hits all enemies in front
AbMobHellFire	Hell Fire
AbMobDoubleSmash	Double Smash
AbMobFastHeal	Fast Heal
AbMobThrust	Thrust
DescMobThrust	A quick controlled strike that also interrupts the target.
AbMobStomp	Stomp
DescMobStomp	Interrupt all enenmies around
AbPredFireBreath	Fire Breath
AbPredFireFlood	Fire Flood
AbMobAcidFlood	Acid Flood
AbMobAcidSpray	Acid Spray
AbMobRottenArmor	Rotten Armor
DescMobRottenArmor	Snižuje target armor by {5}, for {2}, a can stack up to {4} times.
AbMobChew	Chew
AbTwinSmash	Smash
AbMobPierce	Pierce
AbMobSwipeMaim	Swiping Maim
DescMobSwipeMaim	Maims all targets in front for {2}, lowering their [>Haste] by {5}.
AbMobFireball	Fireball
AbMobWarCry	WarCry
DescMobWarCry	Raises Attack Power of nearby allies by {5} for {2}.
AbMobFire	Fire Gun
AbRodentCurse	Rodent Curse
DescRodentCurse	Damages the target for {1} HP over {2}, a can stack up to {4} times. poškození zvyšuje exponentially with stacks.
AbMobSmashFrenzy	Smash Frenzy
AbTrollRegen	Troll Regeneration
DescTrollRegen	Heals for {1} HP over {2}.
AbMobWhirlWind	Whirlwind
AbMobBash	Bash
DescMobBash	A strike made with the edge of the weapon instead of the blade that stuns the target for {2}.
AbDragonFireFlood	Fire Flood
AbWyvernFireFlood	Fire Flood
AbMobFrostWave	Frost Wave
DescMobFrostWave	Sends a wave of ice that snižuje all targets' [>Haste] in its area by {5} for {2}.
AbMobBowSlow	Hunter Trail
DescMobBowSlow	Slows the target for {2}, lowering their [>Haste] by {5}.
AbMobSkullCrusher	Skull Crusher
DescMobSkullCrusher	A strike directly to the head that stuns the target for {2}.
AbMobSoulBan	Soul Ban
AbMobSoulBanned	Soul Banned
DescMobSoulBanned	Reduces all healings by by {5}, for {2}.
AbMobScorch	[>AbScorch]
DescMobScorch	[>DescScorch]
AbMobHarpoon	Harpoon
AbMobSlash	Slash
AbMobBloodSucking	Blood Sucking
AbMobSludgeSpit	Sludge Spit
DescMobSludgeSpit	Absords up to {5} healing. Lasts {2}.
ChTipMobSludgeSpit	\n\nCan still absorb up to {0} healing.
AbMobFireMeteor	Fire Meteor
AbMobArcaneBall	Arcane Ball
AbMobLightning	Lightning
AbMobFireBreath	Fire Breath

//=== Boss Abilities
AbStunOfLight	Stunning Light
DescStunOfLight	A flash of light that stuns all enemies in the area for {2}
AbMobTeleportToBack	Veil of Shadows
AbMobSummon	Minion Summoning
AbLethalFireball	Lethal Fireball
AbDragonShadow	Call of Darkness
AbDragonAcid	Acid Fury
AbBossSwipe	Monumental Swipe
AbBossArrowRain	Rain of Arrows
AbBossArrowRainLight	Rain of Holy Arrows
AbBossArrowRainShadow	Rain of Shadow Arrows
AbBossSniperArrow	Sniper Arrow
AbBossShieldBash	Titanic Shield Bash
DescBossShieldBash	Interrupt a stun the target for 3 seconds.
AbBossSlowEnrage	Slow Enrage
DescBossSlowEnrage	Enrages faster a faster over {2}, dealing up to {5} more poškození.
AbWitchCurse	Witch Curse
DescWitchCurse	Damages the target for {1} HP over {2}, a can stack up to {4} times. poškození zvyšuje exponentially with stacks.
AbWitchBall	Witch Spit
AbWitchHeal	Spirit Healing
AbTeleportPath	Light Warp
AbHunterSniperArrow	[>AbBossSniperArrow]
AbBossDeathRay	Death Ray
AbTeleportWarlock	Shadow Blink
AbWarlockHeal	Shadow Regeneration
AbWarlockCurse	Black Curse
DescWarlockCurse	Damages the target for {1} HP over {2}, a can stack up to {4} times.
AbBossShadowCurse	Shadow Curse
DescBossShadowCurse	[>DescWarlockCurse]
AbBossNova	Super Nova
AbBossNightBall	Night Cloud
AbBossShadowArmor	Shadow Armor
DescBossShadowArmor	Reduces all poškození by {5} for {2}.
AbBossLeechLife	Leech Life
AbTeleportBigBoss	Teleport
AbTeleportBackBigBoss	Regenerate
AbBigBossHeal	Guardian Regeneration
AbSlimeBomb	Slime Bomb
DescSlimeBomb	Snižuje [>Haste] by {5} a burns for {1} HP over {2}.
AbEnergyBlast	Energy Blast
AbEnergyShot	Energy Shot
AbBossFireArmor	Fire Armor
DescBossFireArmor	Reflects {8}25%</color> of incoming poškození to the attackers.
AbBurningHand	Burning Hand
DescBurningHand	Burns the target for {1} HP over {2}.
AbBigBossRegen	Regenerate

//=== Ab Stun Tip
TipStun		Stunned
TipInterrupted	Interrupted!\n\nYour ability {0} has been interrupted by an enemy's attack.

//=== Spec
Specialization	Specializace
SpecProtector	Ochránce
SpecManAtArms	[:Muž|Dáma] ve zbrani
SpecPaladin	Paladin
SpecElementalist	Elementalista
SpecDruid	Druid
SpecPriest	[:Kněz|Kněžka]
SpecNecromancer	Nekromancer
SpecWarlock	Warlok
SpecArcanist	Arkanista
SpecAssassin	Vrah
SpecDuelist	Duelista
SpecRanger	Stopař

DescSpecProtector	The Protector is the quintessence of a tank: he wears plate armor, handle shield, a can mitigate a lot of poškození. He doesn't have any self-healing abilities though, thus he must rely on the healer to heal his wounds.
DescSpecManAtArms	The Man at Arms is a trained soldier especially proficient in 2-handed weapons with which he does devastating poškození.
DescSpecPaladin		The Paladin is a heavily armored knight of the Gods. He's a bit less devastating than the Man at Arms, but he's got a lot of protecting abilities.

DescSpecElementalist	The Elementalist invokes fire & frost to obliterate his enemies, whether in group or alone.
DescSpecWarlock		The Warlock relies mainly on poškození over time spells to slowly but surely drain the life out of their victims.
DescSpecArcanist	The Arcanist uses speed a precision to build intricate flows of arcane, annihilating their enemies.

DescSpecDruid	The Druid mostly uses heal-over-time spells to save the life of his companions.
DescSpecPriest	The Priest relies mainly on shielding the tank to prevent any injuries ; he also can heal when required.
DescSpecNecromancer	The Necromancer is an adept of dark arts, stealing the life of the enemies to better heal the party.

DescSpecAssassin	The Assassin is a master of fast a tricky attacks, building up moves before finishing their enemies.
DescSpecDuelist		The Duelist is an expert at avoiding being hit a teasing the enemies.
DescSpecRanger		The Ranger enjoys tracking a killing their target from a distance, using either a bow or a crossbow.

SpecPoint	Used Points

CanWield	Can wield


//=== Consumable Abilities Desc
AbHealthPotion	Health Potion
DescHealthPotion	A potion that heals for {0} HP. The potency of all healing potions is lowered for {2} after use, a this lowering can stack up to {4} times.
AbManaPotion	Mana Potion
DescManaPotion	A potion that restores {0} Mana Points. The potency of all mana restoring potions is lowered for {2} after use, a this lowering can stack up to {4} times.
AbHastePotion	Haste Potion
DescHastePotion	A potion that raises your [>Haste] rating by {7}{11:F0}</color> for {2}.
AbCritPotion	Critical Potion
DescCritPotion	A potion that raises your critical rating by {7}{11:F0}</color> for {2}.

//=== Talents ====================================================================
NbTalentPoint	Available Points
RequireInTree	Requires {0} point(s) in {1} tree
AlreadyHaveSpec	Not available because this is not your main specialization.
TalentNewAb	Provides this new ability
TalentReplaceAb	Replaces {0} with this new ability
TalentRank	Rank
TalentNextRank	Next Rank
TalentLearn	Left Click to Learn
TalentUnlearn	Right Click to Unlearn
RequireTl	Requires {0} point(s) in {1}
RequireAb	Requires {0}
TalentPoint	{0} Talent Point(s) Available

ConfirmChanges	Confirm Changes
CancelChanges	Cancel Changes

TalentReroll	Reroll\n\nReset all your talent trees a refund you all your talent points.\nYou get 1 reroll point every 4 levels starting at level 1.
TalentNbReroll	You currently have {0} reroll point(s).
TalentNoReroll	You don't have any reroll points left.

// Tl + Name = Talent Name
// Tb + Name = effects that come only with Rank 1
// Tr + Name = effects that are increased on each rank

// {TalentX [G|B] [EffectIndex]}
// {<AbilityUsedByTalent[:TalentPart}> [Dmg|DotLength|DotTotalDmg|MaxStack] [%|f] [#<EffectIndex>]}
// {<AbilityUsedByTalentAddingTick> ExtraTime <OtherAbilityWithDot>}
// {Talent <TalentPartName> Condition <OtherAbilityActive|FamilyActive|HpRatio|ManaRatio|Random>}
// {Talent <TalentPartName> Var [G|B [%]}

//=== Warrior - Protector
TlProtector	[>SpecProtector]
TrProtector	Zvyšuje Health Points by {HP} a [>Block] by {Block}.
TlAnticipation	Anticipation
TrAnticipation	Zvyšuje [>Dodge] chance by {Dodge}.
TlThunderClap	Improved Thunder Clap
TrThunderClap	Zvyšuje [>AbThunderClap] poškození by {WarProtThunderClap}.
TlShieldMaster	Shield Master
TrShieldMaster	Zvyšuje block chances with a shield by {WarProtShield}.
TlArmorMaster	Armor Master
TrArmorMaster	Zvyšuje your [>ArmorRating] from items by {Armor}.
TlDevastating	Devastating
TrDevastating	When the [>AbDevastate] ability damages its target, it also damages another nearby enemy by {TalentX B} of the initial poškození.
TlEnrage	Enraged
TrEnrage	Zvyšuje all poškození done by {Enrage} a snižuje all poškození received by {Enrage #1} for {Enrage DotLength} when casting [>AbRageYell].
TlRetaliate	Retaliate
TrRetaliate	Immediately retaliates when blocking a strike a poškození the attacker by {Retaliate Dmg} poškození (AP based). Produces a bit of extra threat.\n\nAlso raises by {Damage G} the healing done by [>TlHolyAtonement].
TlCounter	Counter Attack
TrCounter       Zvyšuje [>Haste] by {Counter} for {Counter DotLength} after each successful parry. Can stack up to {Counter MaxStack} times.
TlMenacingEyes	Menacing Eyes
TrMenacingEyes	Zvyšuje the threat of all your direct poškození by {TalentX}.
TlMageKiller	Mage Killer
TrMageKiller	Zvyšuje resistances against Arcane, Fire, Frost & Shadow poškození by {ResFire}.\n\nAlso raises by {HigherThreat} the threat produced by [>AbSealOfContrition].

//=== Warrior - Man at Arms
TlManAtArms	[>SpecManAtArms]
TrManAtArms	Zvyšuje poškození with two-handed weapons by {WarArmsRoot}.
TlHardStrike	Improved Hard Strike
TrHardStrike	Zvyšuje [>AbHardStrike] critical chances by {CritChance}.
TlImpale	Impale
TrImpale	Zvyšuje critical poškození bonus of your abilities by {CritDamage}.
TlDeepWound	Deep Wounds
TrDeepWound	Your critical strikes cause your target to bleed, dealing {TalentX B} of your weapon average poškození over {Bleeding DotLength}. Stacks up to {Bleeding MaxStack} times.
TlExecute	Execute
TrExecute	[>AbDeadlyAssault]'s poškození is raised by {Damage} if the target health is under 25%.
TlDoomDrum	[>AbDoomDrum]
TrDoomDrum	Adds [>AbDoomDrum] effect to [>AbWarCry] that Snižuje surrounding enemies' Attack Power by {DoomDrum} for {DoomDrum DotLength}.
TlLustForBlood	Lust For Blood
TrLustForBlood	All your abilities' direct poškození is raised by {Damage} if the target is bleeding.
TlFriendlyFace	Friendly Face
TrFriendlyFace	Snižuje threat of all your direct poškození by {TalentX}.
TlSpec1H	One-Hand Specialization
TrSpec1H	Zvyšuje all poškození by {Damage} when wielding one-handed weapons.
TlSpec2H	Two-Hand Specialization
TrSpec2H	Zvyšuje all poškození by {Damage} when wielding two-handed weapons.\n\nAlso snižuje by {LowerManaCost} the mana cost of [>AbCrusaderAssault].
TlMeatPounder	[>AbMeatPounder]
TrMeatPounder	[>AbSwipe] makes [>AbHardStrike] hit 1 more target for {MeatPounder DotLength}.
TlGoodPatient	Good Patient
TrGoodPatient	Zvyšuje all healing received by {IncreaseHealing}.
TlTitanGrip	Titan Fist
TrTitanGrip	Allows to dual wield two-handed & bastard weapons.

//=== Warrior - Paladin
TlPaladin	[>SpecPaladin]
TrPaladin	Gives Mana Points for {TalentX} of your Base HP.
TlEnlightment	Enlightenment
TrEnlightment	Raises Mana Points by {TalentX} of your Base HP.
TlScarification	Scarification
TrScarification	Raises your Spell Power by {TalentX} of your Attack Power.
TlGodsAreWithUs	The Gods Are With Us
TrGodsAreWithUs	Your abilities' critical hits heal you for {TalentX} of the poškození done.
TlHolierBarrier	[>AbHolierBarrier]
//TrHolierBarrier	Zvyšuje the magic protection of [>HolyBarrier] by {ResHoly}.
TlSealOfRepentance	[>AbSealOfRepentance]
TrSealOfRepentance	When you cast [>AbSealOfContrition], [>AbSealOfRepentance] is also applied on the target, which raises all incoming attacks' critical chance by {SealOfRepentance}.
TlHolyAtonement	Holy Atonement
TrHolyAtonement	Casting [>AbHolierBarrier] also heals you for {HolyAtonement Dmg} HP.
TlAngerOfGods	Anger Of Gods
TrAngerOfGods	Raises critical chance of [>AbDivinePunishment] by {CritChance} a poškození of [>AbSealOfContrition] by {Damage}.
TlWrathOfTheJust	Wrath of the Just
TrWrathOfTheJust	Zvyšuje all physical poškození by {Damage} when weilding a shield.
TlSpiritualShock	[>AbSpiritualShock]
TrSpiritualShock        When [>AbCrusaderAssault] hits 3 enemies or more, then 1 of them is stunned for {SpiritualShock DotLength}. This effect can't occur more than once every 30 seconds.
TlSeraphicIntervention	[>AbSeraphicIntervention]
TlJusticeForAll	Justice For All
TrJusticeForAll	Raises poškození of [>AbHammerOfJustice] a [>AbOverwhelmingBlow] by {Damage}.
TlNoSacrificeInVain	[>AbNoSacrificeInVain]
TrNoSacrificeInVain	Casting [>AbSaintlySacrifice] applies [>AbNoSacrificeInVain] on youself, which will heal you by {NoSacrificeInVain DotEndDmg} HP after {NoSacrificeInVain DotLength}.

//=== Rogue - Assassin
TlAssassin	[>SpecAssassin]
TrAssassin	Zvyšuje your [>DmgNature] based poškození by {Damage}.
TlToxicKnife	Toxic Knife
TbToxicKnife	Critical hits of [>AbSwiftKnife] applies [>AbPoison] which damages the target for {Poison DotTotalDmg} HP over {Poison DotLength} a can stack up to {Poison MaxStack} times.
TrToxicKnife	Zvyšuje critical chances of [>AbSwiftKnife] by {CritChance}.
TlSmoothCriminal	Smooth Criminal
TrSmoothCriminal	Snižuje threat of all your direct poškození by {TalentX}, a also Snižuje threat of [>AbSweepingBlow] a [>AbDeepCut] by {LowerThreat:RogueAssSmoothCriminalB}.
TlDaggerSpecialist	Dagger Specialist
TrDaggerSpecialist	Zvyšuje all poškození done with Daggers by {Damage}, a poškození of [>AbSwiftKnife] by {Damage:RogueAssDaggerSpecialistB}.
TlUnstoppable	Unstoppable
TrUnstoppable	The critical hits of your abilities that add [>ComboPoints] have {Talent RogueAssUnstoppable Condition Random} chance to give 1 additional [>ComboPoint].
TlPoisonedBlade	Poisoned Blade
TrPoisonedBlade	[>AbDreadfulJab]'s hits have {Talent RogueAssPoisonedBlade Condition Random} chance to apply [>AbPoison] which damages the target for {Poison DotTotalDmg} HP over {Poison DotLength} a can stack up to {Poison MaxStack} times.
TlCurare	A Pinch of Curare		// wordplay: Pinch of Salt
TrCurare	Raises poškození of [>AbPoison] by {Damage}.
TlSnakeTouch	Touch of the Snake
TrSnakeTouch	Auto-attacks' hits have {Talent RogueAssSnakeTouch Condition Random} chance to apply [>AbPoison] which damages the target for {Poison DotTotalDmg} HP over {Poison DotLength} a can stack up to {Poison MaxStack} times.
TlNeverEndingStory	NeverEnding Story	// Name of Movie
TrNeverEndingStory	Your Streak Climax abilities' hits have {Talent RogueAssNeverEndingStory Condition Random} chance to give 1 [>ComboPoint].
TlSideAttack	Side Attack
TrSideAttack	Your [>AbDreadfulJab]'s successful hits also hit a nearby enemy with your off-hand weapon for {DreadfulJabOffHand Dmg} poškození.\n\nAlso zvyšuje your [>Agi] by {Agility f}.
TlTraumatologist	Traumatologist
TrTraumatologist	Zvyšuje melee critical poškození bonus by {TalentX B}.
TlBloodAddict	Blood Addict
TrBloodAddict	[>AbExecute]'s successful hits extend [>AbKillingSpree] by {Eval TalentX * 6} seconds for each [>ComboPoint].

//=== Rogue - Duelist
TlDuelist	[>SpecDuelist]
TrDuelist	Zvyšuje your [>Dodge] a [>Parry] chances by {Dodge}.
TlReinforcedLeather	Reinforced Leather
TrReinforcedLeather	Zvyšuje your [>ArmorRating] from items by {Armor}.
TlSlipperyFish	[>AbSlipperyFish]
TrSlipperyFish	Snižuje critical chances of all direct hits against you by {LowerCritChance}, a triggers [>AbSlipperyFish] when you get critically hit which raises your [>Dodge] chance by {SlipperyFish} for {SlipperyFish DotLength}.
TlSleightOfHand	[>AbSleightOfHand]
TrSleightOfHand	Auto-attacks' hits have {Talent RogueDuelSleightOfHand Condition Random} chance to apply [>AbSleightOfHand] that Snižuje target's Attack Power by {SleightOfHand} for {SleightOfHand DotLength} a can stack up to {SleightOfHand MaxStack} times.
TlEscapeArtist	Escape Artist
TrEscapeArtist	Raises your [>ArmorRating] by {ArmorFromAgi f} (based on your [>Agi]).
TlRiposte	Riposte
TrRiposte	Your successful dodge a parry have {Talent RogueDuelRiposte Condition Random} chance to trigger [>AbRiposte] which zvyšuje all your physical poškození by {Riposte B} for {Riposte DotLength}.
TlInfectedWound	Infected Wound
TrInfectedWound	Adds {AddDotTick f} tick(s) to [>AbDeepCut], a [>AbLunge] has {Talent RogueDuelInfectedWoundB Condition Random} chance to reset the duration of your [>AbDeepCut] afflicting the target.
TlTillTheLastDrop	Till the Last Drop
TrTillTheLastDrop	Zvyšuje your Total Health Points by {HP}.
TlAggressiveStance	Aggressive Stance
TrAggressiveStance	Zvyšuje the threat of all your direct poškození by {TalentX}.
TlGoneWithTheWind	Gone With the Wind	// Movie Title
TrGoneWithTheWind	When you're hit by a projectile you have {Talent RogueDuelGoneWithTheWind Condition Random} chance to completely avoid the poškození. This effect can't occur more than once every 20 seconds.
TlStingLikeBee	Sting Like a Bee	// Muhammad Ali's quote
TrStingLikeBee	Zvyšuje [>Dodge] a [>Parry] chances by {StingLikeBee} when not wielding a shield.\nAlso zvyšuje [>AbSwiftKnife]'s threat by {HigherThreat:RogueDuelStingLikeBeeB}, a poškození of [>AbDoubleShot] by {Damage}.
TlDualDrill	Dual Drill
TrDualDrill	When you don't weild a shield, your [>AbPiercingStrike]'s successful hits also poškození with your off-hand weapon a nearby enemy, preferably one not currently attacking you.
TlTastierBlood	Tastier Blood
TrTastierBlood	Zvyšuje healing done by [>AbRecovery] by {IncreaseHealing}.

//=== Rogue - Ranger
TlRanger	[>SpecRanger]
TrRanger	Zvyšuje your total [>Agi] by {AgilityMultiply}.
TlQuickAim	Quick Aim
TrQuickAim	Zvyšuje your [>Haste] by {Haste}.
TlFocusedHunting	Focused Hunting
TrFocusedHunting	Raises your [>RAP] by {RapFromAwa f} (based on your [>Awa]).
TlMarksman	Marksman
TrMarksman	Zvyšuje poškození of [>AbSniperShot] a [>AbDoubleShot] by {Damage}, a your auto-attacks' successful hits have {Talent RogueRangerMarksmanB Condition Random} chance to grants you 1 [>ComboPoint].
TlHunterTracking	[>AbHunterTracking]
TrHunterTracking	Snižuje all your threat by {LowerThreat}.
TlHardenedSteel	Hardened Steel
TrHardenedSteel	Critical strikes of your abilities trigger [>AbHemorrhage] which damages the target for {TalentX B} of the initial poškození over {Hemorrhage DotLength}.
TlFrenzyStreak	Frenzy Streak
TrFrenzyStreak	Your auto-attacks poškození is increased by {TalentX B} for each [>ComboPoint] you currently have.
TlRepeatingShot	Repeating Shot
TrRepeatingShot	Your ranged auto-attack has {Talent RogueRangerRepeatingShot Condition Random} chance to send a 2nd projectile.
TlMaimThenKill	[>AbMaimThenKill]
TrMaimThenKill	Your [>AbInstinctShot] critical hits trigger [>AbMaimThenKill] which raises [>AbSniperShot] poškození by {TalentX B} for {MaimThenKill DotLength}.
TlSharpShooter	Sharpshooter
TrSharpShooter	Zvyšuje ranged critical poškození bonus by {TalentX B}, a poškození of [>AbSwiftKnife] by {Damage}.
TlHeavyBarrage	Heavy Barrage
TrHeavyBarrage	Zvyšuje poškození of [>AbVolleyOfArrows] by {Damage}, a critical chance of [>AbDoubleShot] by {CritChance}.
TlSurvivalInstinct	Survival Instinct
TrSurvivalInstinct	When [>AbNightOfTheHunter] is active, all incoming poškození is lowered by {LowerDamage}.

//=== Mage - Elementalist
TlElementalist	[>SpecElementalist]
TrElementalist	Zvyšuje critical chances of all [>DmgFire] & [>DmgFrost] Damages založených útoků by {CritChance}.
TlSpeedyEle	Swift Elements
TrSpeedyEle	Reduces cast time of [>AbFrostbolt], [>AbFireball] a [>AbArcaneBurst] by {AbsoluteSpeed f} second(s).
TlIgnite	[>AbIgnite]
TrIgnite	[>AbFireball]'s critical strikes cause the target to burn for {TalentX B} of initial poškození over {Ignite DotLength}.\nAlso zvyšuje poškození of [>AbHellFire] by {Damage}.
TlIceShield	[>AbIceShield]
TlWaterfallShield	Waterfall Shield
TrWaterfallShield	When you cast [>AbIceShield] on yourself, [>AbWaterShield] is applied to all other party members.
TlHappyRain	Only Happy When it Rains
TrHappyRain	Zvyšuje [>AbRainOfFire] poškození by {Damage} a snižuje its cooldown by {CoolDown}.
TlChainSmoking	Chain Smoking
TrChainSmoking	Snižuje mana cost of all your spells by {LowerManaCost} a their threat by {LowerThreat}.
TlBurnBabyBurn	Burn Baby Burn
TrBurnBabyBurn	Snižuje mana cost of [>AbScorch] by {LowerManaCost} a raises its over time poškození by {Damage}.
TlFullCombustion	Full Combustion
TrFullCombustion	Zvyšuje poškození all of your Fire spells by {Damage}.
TlKnockCold	Knock Cold
TrKnockCold	Raises critical poškození of all Frost spells by {CritDamage} a snižuje their mana cost by {LowerManaCost}.
TlFlashFreezing	Flash Freezing
TrFlashFreezing	[>AbIceblast]'s target gets their [>Haste] lowered by {FlashFreezing} for {FlashFreezing DotLength}.
TlIceStorm	Ice Storm
TrIceStorm	Each spell cast has {Talent MageEleFlashIceStorm Condition Random} chance to reset [>AbIceblast]'s cooldown.
TlSelfFulfillment	Self-Fulfillment
TrSelfFulfillment	Non-periodical spell criticals refund {TalentX} of their spell Mana cost.
TlCauterize	[>AbCauterize]
TrCauterize	Attacks that bring you at 0 HP restore {TalentX} of your total HP but this effect will burn you for {TalentX B 2} of your total HP over {Cauterize DotLength} ; this effect can't happen more than once per minute.

//=== Mage - Warlock
TlWarlock	[>SpecWarlock]
TrWarlock	Zvyšuje poškození of all [>DmgShadow] spells by {Damage}.
TlMovingShadows	Moving Shadows
TrMovingShadows	Snižuje cast time of [>AbShadowBall] a [>AbDominate] by {AbsoluteSpeed f} second(s).
TlMoreTorment	More Torment
TrMoreTorment	Zvyšuje by {Damage} [>AbTorment]'s poškození.
TlPiercingCurse	Piercing Curse
TrPiercingCurse	Allows each damage-over-time abilities' tick to have {DotCritChance} of your normal critical chance.
TlGloomyDoom	Gloomy Doom
TrGloomyDoom	Raises the critical chance of [>AbDirePlague]'s tick by {CritChance}.
TlMakeItWorthThePain	Make it Worth the Pain
TrMakeItWorthThePain	Raises by {DamageMana G} the Mana generated from [>AbLethalEmpowerment] without raising its poškození.
TlOvercooked	Overcooked
TrOvercooked	Raises by {Talent MageLockOvercooked Var B %} the length a poškození of [>AbHellFire].
TlSpiritSiphon	Spirit Siphon
TrSpiritSiphon	Each [>AbTorment] tick has {Talent MageLockSpiritSiphon Condition Random} chance to heal you for {TalentX} of your Total Health.
TlAcutePain	Acute Pain
TrAcutePain	Zvyšuje the critical poškození of Shadow a Fire spells by {CritDamage}.
TlDrainDry	Drain Dry
TrDrainDry	Zvyšuje the poškození & healing of [>AbDrainLife] by {Damage} for each of your active DOT spell on the target.\n\nAlso snižuje all your threat by {LowerThreat}.
TlUnendingTorment	Unending Torment
TrUnendingTorment       Your [>AbDominate] a [>AbShadowBall] spells have {Talent MageLockUnendingTorment Condition Random} chance to reset the duration of your [>AbTorment] afflicting the target.
TlBattleMage	Battle Mage
TrBattleMage	Raises by {TalentX} your total HP, a your physical poškození by {Damage}.
TlDarkWisdom	Dark Wisdom
TrDarkWisdom	Raises by {TalentX} your total Mana.

//=== Mage - Arcanist
TlArcanist	[>SpecArcanist]
TrArcanist	Zvyšuje your [>DmgArcane] based poškození by {Damage}.
TlFasterThanLight	Faster Than Light
TrFasterThanLight	Raises your [>Haste] by {Haste}.
TlArcaneFusion	[>AbArcaneFusion]
TrArcaneFusion	[>AbArcaneRupture] & [>AbArcaneImplosion] hits have {Talent MageArcaneFusion Condition Random} chance to trigger [>AbArcaneFusion] on the target, which damages the target for {ArcaneFusion DotTotalDmg} HP over {ArcaneFusion DotLength} a can stack up to {ArcaneFusion MaxStack} times.
TlSurvivalOfTheFittest	Survival Of The Fittest
TrSurvivalOfTheFittest	[>AbArcaneArmor] lasts {AddDotTick ExtraTime ArcaneArmor} longer.
TlMentalArmor	Mental Armor
TrMentalArmor	Raises your [>ArmorRating] by {MentalArmor} a all your resistances by {MentalResistance f}% (based on your [>Wil]).
TlEthericEnergy	[>AbEthericEnergy]
TrEthericEnergy	Each damaging spell has {Talent MageArcaneEthericEnergy Condition Random} chance to trigger [>AbEthericEnergy] which Snižuje Mana cost all of your spells by {EthericEnergy} for {EthericEnergy DotLength}.
TlEthericCelerity	Etheric Celerity
TrEthericCelerity	When [>AbEthericEnergy] is active, your [>Haste] is also raised by {Haste}.
TlEthericConvergence	Etheric Convergence
TrEthericConvergence	When [>AbEthericEnergy] is active, your [>ManaCbRg] is also raised by {TalentX}.
TlEsotericAlteration	Esoteric Alteration
TrEsotericAlteration	[>AbEsotericConnection] lasts {AddDotTick ExtraTime EsotericConnection} longer.
TlMultipleRupture	Multiple Rupture
TrMultipleRupture	Snižuje cooldown of [>AbArcaneRupture] by {CoolDown} a its mana cost by {LowerManaCost}.
TlManaAddict	Mana Addict
TrManaAddict	Zvyšuje your poškození up to {TalentX} depending of your ratio of Mana left.
TlImplosionDust	Implosion Dust
TrImplosionDust	Refills {TalentX} of your total Mana when [>AbArcaneImplosion] critically hits.\n\nAlso snižuje all your threat by {LowerThreat}.

//=== Healer - Druid
TlDruid		[>SpecDruid]
TrDruid		Zvyšuje mana regeneration outside of combat by {ManaRegen}.
TlClearState	Clear State
TrClearState	Zvyšuje critical chances of all healing effects by {CritChance G}.
TlAcutePersistance	Acute Persistance
TrAcutePersistance	Allows each healing-over-time abilities' tick to have a critical chance.
TlMeditation	Meditation
TrMeditation	Zvyšuje mana regeneration during combat by {CombatManaRegen}.
TlWildRegrowth	[>AbWildRegrowth]
TrWildRegrowth	When you cast [>AbRegrowth] on a party member, [>AbWildRegrowth] will be applied to the other party member who lost most HP, healing him for {TalentX} of [>AbRegrowth] over {WildRegrowth DotLength}.
TlDanceOfStars	[>AbDanceOfStars]
TrDanceOfStars	Applies [>AbDanceOfStars] when [>AbDanceOfGaia] ends, healing each party member for {TalentX} of total [>AbDanceOfGaia]'s healing over {DanceOfStars DotLength}.
TlEternalBloom	Eternal Bloom
TrEternalBloom	[>AbLifeBloom] rewards {TalentX} of its mana cost when ending (up to 3 stacks).
TlHigherState	Higher State of Consciousness
TrHigherState	Raises [>Awa] by {Awareness}.
TlNaturalWay	Natural Way
TrNaturalWay	Zvyšuje healing of [>AbHeal] a [>AbRegrowth] by {Damage G}.
TlBarkskin	Barkskin
TrBarkskin	Zvyšuje resistances against all magic by {ResHoly} a snižuje all healing spell threat by {LowerThreat}.
TlRegrowthMana	[>AbRegrowthMana]
TrRegrowthMana	Each [>AbRegrowth] tick has 1% chance to give you a Mana regeneration of {TalentX} of your Total Mana over {RegrowthMana DotLength}.
TlSelfPreservation	Self Preservation
TrSelfPreservation	Each time you get attacked when your HP is below {Talent HealDruidSelfPreservation Condition HpRatio}, you have {Talent HealDruidSelfPreservation Condition Random} chance to cast [>AbRegrowth] on yourself for no mana cost.
TlPurifiedRain	Purified Rain
TrPurifiedRain	Snižuje cooldown of [>AbRainOfLife] by {CoolDown}, its mana cost by {LowerManaCost} a its threat by {LowerThreat}.

//=== Healer - Priest
TlPriest	[>SpecPriest]
TlExtendedProtection	Extended Protection
TrExtendedProtection	When [>AbRighteousShield] is ended by an enemy attack, there's a {Talent HealPriestExtendedProtection Condition Random} chance to apply [>AbRenew] on the ally.
TlStrongerShield	Stronger Shield
TrStrongerShield	Zvyšuje by {Talent HealPriestStrongerShield Var G %} the poškození absorbed by [>AbRighteousShield].
TlAbsolution	Absolution
TrAbsolution	Snižuje cooldown of [>AbRighteousShield] by {CoolDown}.
TlHolyDiligence	[>AbHolyDiligence]
TrHolyDiligence	Zvyšuje your [>Haste] by {HolyDiligence} for {HolyDiligence DotLength} each time you cast [>AbRighteousShield], a reduces cast time of [>AbPrayerOfRedemption] by {AbsoluteSpeed f} second(s).
TlStrongerFaith	Stronger Faith
TrStrongerFaith	Zvyšuje by {Damage G} the healing of [>AbBlessedSpirit], [>AbFlashHeal] a [>AbTwinHeal].
TlSpiritualCommunion	Spiritual Communion
TrSpiritualCommunion	When your direct healing spells are critical, [>AbSpiritualEffervescence] is applied on the target a absorbs up to {TalentX} of the amount healed over {SpiritualEffervescence DotLength}. The absorbing charge stacks with each critical spell.
TlArchangelWatch	[>AbArchangelWatch]
TrArchangelWatch	Cast on yourself [>AbArchangelWatch] every time you get hit, which snižuje poškození by {TalentX} over {ArchangelWatch DotLength}.
TlDivineGrace	[>AbDivineGrace]
TrDivineGrace	Raises healing done by {TalentX} for {DivineGrace DotLength} when you cast [>AbFlashHeal], [>AbSacrament] a [>AbTwinHeal] ; stacks up to 3 times.
TlGodlyGuidance	Godly Guidance
TrGodlyGuidance	Snižuje by {LowerManaCost} the mana cost of all your healing spells.
TlBlindFaith	Blind Faith
TrBlindFaith	Raises your [>Haste] by {Haste}.
TlRenewal	Renewal
TrRenewal	Add 1 tick to [>AbRenew].
TlBlessedSpirit	[>AbBlessedSpirit]

//=== Healer - Necromancer
TlNecromancer	[>SpecNecromancer]
TrNecromancer	Zvyšuje Health Points by {HealNecroRoot}.
TlDeadKingdom	Power from the Dead Kingdom
TrDeadKingdom	The whole party has {Talent HealNecroDeadKingdom Condition Random} chance to restore {TalentX} of its total mana any time you do poškození with [>AbSoulSucking] a [>AbSoulEater] spells, a {Talent HealNecroDeadKingdomC Condition Random} chance when you do poškození with your auto-attacks.
TlTheChosenOne	The Chosen One
TrTheChosenOne	Raises by {Damage G} the final healing of [>AbSealOfNecromancy].
TlFromDeathComesLife	[>AbFromDeathComesLife]
TrFromDeathComesLife	When your health is lowered to 0, [>AbFromDeathComesLife] is applied on all your conscious allies, which will heal them for {FromDeathComesLife DotTotalDmg} HP over {FromDeathComesLife DotLength}.\n\nCan happen once per minute.
TlOpenBuffet	Open Buffet
TrOpenBuffet	Raises by {TalentX} the healing done by [>AbEatMyFlesh]. This doesn't raise the poškození done to you.
TlSoulFeast	Soul Feast
TrSoulFeast	[>AbSoulSucking] heals another ally for {TalentX} of the initial amount.
TlLateSupper	Late Supper
TrLateSupper	Adds {AddDotTick f} tick(s) to [>AbSoulEater], but raises its cooldown by {CoolDown B}.
TlShadowArmy	[>AbShadowArmy]
TrShadowArmy	Applies [>AbShadowArmy] on the whole party when you cast [>AbArmyOfDarkness], which snižuje all poškození taken by {TalentX} for {ShadowArmy DotLength}.
TlAngrySpirits	Angry Spirits
TrAngrySpirits	Raises the poškození of all your attack spells by {Damage}.
TlDarkArts	Dark Arts
TrDarkArts	Raises your total mana points by {TalentX}.
TlOneFootInBothWorld	One Foot in Both Worlds
TrOneFootInBothWorld	Snižuje all poškození done to you by {TalentX G}.
TlLastBreath	[>AbLastBreath]
TrLastBreath	Applies [>AbLastBreath] on your [>AbLastIncantation]'s target, which raises their [>Haste] by {LastBreath} over {LastBreath DotLength}.

//=== Global Icons
GiAttack	Attack
GidAttack	Attack\n\nSelect a target first.
GiAttackStop	Stop Attacking
GiSelectAll	Toggle Selected Party Members\n\nRight-click to lock/unlock the current selection.
GiHealthPotion	Health Potion
GidHealthPotion	No Health Potion in Inventory
GiManaPotion	Mana Potion
GidManaPotion	No Mana Potion in Inventory
GiInventory	Inventory
GiTalentTree	Talent Tree
GiChatLog	Dialogue Log
GiMap		Map\n\nClick on Map to add a note.\nClick on a note to edit it.\nRight-click on a note to delete it.\nDrag a note by its nail.\nClick a note's nail to fold & unfold it.
GiClose		Close
GiMenu		System Menu

NoteColor	Změna barvy pro nové poznámky

InInventory	\n\nIn Inventory: {0}
LogWin		"DungeonGuardians_Data\output_log.txt" (within the installation folder)
LogOsx		~/Library/Logs/Unity/Player.log
LogLinux	~/.config/unity3d/CompanyName/ProductName/Player.log
LogWhere	Location Unknown ; check this page to know where to find the log file http://docs.unity3d.com/Manual/LogFiles.html
CrashTip	Game Loop crashed !\n\nIt's recommended to reload your last saved game, especially if the counters keep raising.\nPossibly, send this file to contact@managames.com : {0} ; a your last saved game (go to the [>LoadGame] menu a click on the "[>ShowDataFolder]" button a the saved games will be in the "Saves" folder).
LoadCrashed	Load crashed !\n\nIt's recommended to try to load another saved game, especially if you see the broken shield icon at the top right of the screen if you try to play now.

LoopGame	Game
LoopAI		AI
LoopGUI		GUI
LoopInit	Init

//=== Enchantments
Enchantment	Provedení
EnchBear	{0} medvěda
EnchBandit	{0} bandity
EnchBeast	{0} bestie
EnchBedrock	{0} země
EnchBoulderpeak {0} vrcholu
EnchEagle	{0} orla
EnchGroundbreaker 	{0} pukající země
EnchEarthfall	{0} padající země
EnchEarthshaker {0} zemětřasa
EnchElder	{0} starších
EnchRift	{0} zlomu
EnchFeverflare	{0} pochodně //  of the Feverflare
EnchQuicksand	{0} zrádného písku
EnchFireflash	{0} jiskry
EnchJourneyMan	{0} cestáře
EnchMerchant	{0} kupce
EnchApprentice	{0} učedníka
EnchBlackSmith	{0} kováře
EnchJuggler	{0} kejklíře
EnchTempest	{0} bouře
EnchLandslide	{0} laviny
EnchMarksman	{0} střelce
EnchMonkey	{0} opice
EnchSoldier 	{0} vojáka
EnchStormgale	{0} větrníku // of the Stormgale
EnchWindstorm	{0} vichřice
EnchBarricade	{0} barikády
EnchEscape	{0} útěku
EnchOwl		{0} sovy
EnchHyena	{0} hyeny
EnchWallbreaker	{0} bořiče // of the Wallbreaker
EnchGolem	{0} golema
EnchWindmaker	{0} bouřliváka // of the Windmaker
EnchDirerock	{0} hrozby // of the Direrock
EnchAssassin	{0} vraha
EnchWizard	{0} čaroděje
EnchLightning	{0} blesku
EnchGrinder	{0} drtiče
EnchBurningHand	{0} plamene // of the Burning Hand
EnchMagician	{0} kouzelníka // of the Magician
EnchSeer	{0} jasnovidce
EnchDoom	{0} skázy
EnchLight	{0} světla
EnchFocused	{0} nezlomného
EnchSurvivor	{0} vytrvalce
EnchThunderblast	{0} hromu
EnchFox		{0} lišky
EnchSwan	{0} labutě
EnchLion	{0} lva
EnchWhale	{0} velryby
EnchDeer	{0} jelena
EnchSun		{0} slunce
EnchRebel	{0} rebela
EnchScorpion	{0} škorpióna
EnchIcefall	{0} jinovatky
EnchExpert	{0} experta
EnchJoker	{0} vtipálka
EnchMage	{0} mága
EnchCrystal	{0} krystalu
EnchWasp	{0} vosy
EnchDash	{0} odmlky // of the Dash
EnchStone	{0} kamene	//##
EnchMonolith	{0} monolitu	//##
EnchTiger	{0} tigra	//##
//Ench	{0} of the
